####################
#  H  S H    H  H  #
#S HS      S       #
#            p H   #
#      HH    H     #
#            S     #
#  S   H   SH     S#
#         H S H    #
#     H            #
####################
