####################
#         S    S   #
#      H H         #
#             H  H #
#S p        HH     #
#     H            #
#    S      H S    #
#                  #
#             S    #
####################
