####################
#       H     H    #
#      H       S  H#
# S   H H       H  #
#            H   H #
#                 p#
#  H  S     S      #
#                  #
#                  #
####################
