####################
#        S       H #
#            H     #
#      S   H S p  S#
#        H         #
# H            H  H#
#         S        #
#H    H          H #
#                  #
####################
