####################
#     H      H     #
#        H p H     #
#                  #
#        H  H      #
#                S #
#  H             H #
#        S         #
#H          SH  H  #
####################
