####################
#            H H H #
#H            S    #
#   H     H      H #
#            S     #
#H HH H  H  H   H  #
#                  #
#p  H   H          #
#             H    #
####################
