####################
#p    S   S      HH#
#      S           #
#         H S SHS  #
#       H       S  #
#         S        #
#                  #
#        H      S  #
#     S H         H#
####################
