####################
#           S  HH  #
#                H #
# H         H      #
#    H    H       p#
#      H    H      #
#    H             #
#   S S  H        S#
#   S             S#
####################
