####################
#                  #
#                  #
#H                 #
#            H     #
#                  #
#         S        #
#          H  H    #
#       S          #
####################
