####################
#  S H             #
#                 H#
#         H        #
#   S     S      H #
#                 S#
#            HH  S #
#               H  #p#   S              #
####################
