#########################
#                       #
#                       #
#           e           #
#                       #
#                       #
#           p            #
#                       #
#                       #
#########################