####################################################################################################
#HbMFCbCCMFRHRfHFFbMfBRRbRSbCCHbbCHSBMMHCHRFbbMCbFbFMCFCHbMHMRbfHCMMSfSRMCFBCbRFSbHRRfCFCRMRCbCBRBM#
#BSCfSSRbRfBfSRFBMRRSHHCFCMfRHfRbfMbFBfHffMSFBBRCFCHMbfCMCBFRSMbBMSCFRCMRCHFBfFMHRBFFCRHMCFbFHRMHBF#
#CBFBHHfCSbRHMHRbMbSfCCfFSSSHfMMRMFCBBHfMFfCSfMfbSRRRfHSbbSRMBCffCSHFHCBfBRSSCbBMfCHfCFfCFRfbMbMbfb#
#CSFHfBMbbRMfBCSCRCHCRbFRBCSBFMCbBSMCMbFfSRHbCBBHbSMRBbMbbCBSSbMBbbfSbBBfBCCSHFfMHHbRFCMSBFHbFfBFFC#
#bMBFfMSCfRHFBBSBBRMfMCbFMSBBSFFMMMBHSbfSHRCfMfFHFRfMMSBCFFSCMMHfFHFBMCfCbSHFfRCFRBBCSCbffMCFSCFFBH#
#bSRHSBHFRSHbbBBbfBRHRFSfMRBSbSSSBFHbHBbFMRHbBbSbFHRBfbbBRfSHHbBBfFHfRSMFCBCHbSHMfCfBRRRHHCBMRSfHSC#
#RbbCCfbfBfHSMbfFfbCbbbBMFCBBBRBRFBCSFFfMfCMMMCFbCSRRSMCbHHbHHFMHBbBCRFBHMSHFfCCFCCFMSFBfCfBFRffMSb#
#MHHMHCMHSfFHfBRBfRMBCFbBMfMHCMfFHbBffSBfMbfRbFCBBBbfBbCfSSMbSfMHFFRHfSCRCbMBHHHHMMFHCfBHbRBfBMMSRM#
#HCffRSRBBSBMbHSSSRBHbbBFCFCFSFSMBHBFMMBCCCRBSBFMBRfHbffFCMRFSbRSCFSFSCSRSfBRbFFBFfbBHCfFCfMHfRFRRF#
#FCCCbCFFHRbBFMSfbCFFSHSHBBHHBCbMBBFRFbCHMHHMfHSRfBfbHRSbRFSSSSHBMCMbSfHMFRRfRSbFFbBCBHbSRRFMHfbHFB#
#MBfbCbSBCBHSFHCRRMbFSMfRbFRMBSHSfFHHHRCHBfRSFbMHfBCbBHBSHSRSFFMMRBBRfMRRCMRFfRSMBMCBMRSSfBMFSRFfMF#
#RFFfMMBFBbbHBSMMHbBHbFSSBFFMbCHMRFBbbbHBHCFSBFbSMBSCFBRfHRFSRHSFHMSBHSHfHHHMMfBCbHMCRbSFbBCMbCbBMH#
#BHHbfBFbHCHCRBbMRSFBbBSHMFSBSbfHBfRSRSFHRbRbBSCHBbMfbfMCRBHbHCSFSRBfSFFbCHHbbHFBRFbMHBFMSMHHBSffRM#
#HHBRHCbHSCSfSfBCFFBMMSSCCbbCffMFMbSMBRBHbFRfSHBCFMBCbbFbSCSRSbRBCFfRBbRMSBHHRFHFMbffHBSBRBHfSFSBMM#
#RFRMCfFBFfMRfbbFfFFbbCbRBbbfRHRFRRBSFFSbBHSMfFbHMbFbCHCfFbbRBSRMHbHBSbSFMFBfBCBSRfSBbMRfFSfRfRSSSf#
#BbHFRRBCMBbRCSffBFRfFHHMMbSHfMBHBCFfMMFBfHbSFMMBfbFBfRbCHBSbfFSfFSbFfCRHFHCSHMbCSRfHMBfbHCFMbMSSfC#
#MffFFbFFMBfMbBSbfSSMBbBMBCFbBBRfbfFRRCHFBRFBFMMfHBbCSRHHRCRBRbCbFCCbRSFBHbCRSFCMRFRHfSHHFCSBSFCFFF#
#RBFCBMFHRBRCMSFbbRRHCfHFbbRSFSRSSbBHMfCSHBBSBbSHffCfHfbFFCfbFHCHSRRFRBSfSSHBHFFSRCMfbfBHCbSCRSMbbH#
#bSfMSbHbRfSMBRbbFFfRBFMRRRRBRSHMFHbHHCMMMHSMSbBCFHRCbMCfCMBCBfHHSSHCMFSBfSMbHSHRCSRMRbRFbfMCRHCMHM#
#FBBCRMfMSHHRfHfBFBFbbCHSFFSFMFBRSBSSSMRfbFMRFFbbMCfRbFRfSSFRMRffRCbbMCRSHCCBHbfSFMHMFCCCSfHSRBbMRC#
#BSRSCbfSMCSCbRFMHRFRFSFMBMMCbSMfBMbfCbbBHFCMFBCFRbSHSCRCFfFHCFHFRSbfCFfFRfHSMbFCSBFCRCSRbFRCBCfbBb#
#fCbfCBFfCRFCbSHRbRHRBfRBHCCCHHCHHbfCBHHSMbFfMFFHBSRfRHBSbRSFbSCbFMFCRMMHbbHbSBRBfFFMRBBHCSFFRHSBMF#
#FSMbfSHfHMRFCSRbMMFffBHMRSCHCbRBfHHBffCHRfbfMRSbMfCfHSHMMFbSHHRSRBMCFSFMMMMHfHRCCMHbRBCbCfBCbSMMRC#
#fMFFSSHCSfSRRffRCFFHBbFBSFbMfRHMBBHBCSBbHBbCMbHFCHRCfMFCbBfFBFRbbSCFBbMCSMHHFFHFMSfBCMBfbHBHMHCMBC#
#HFHRHHHBSBRfRRHMSFCFRRRBSSBCMBMfbBFCBRfCRfBFHbCbFbfMHFMFHSCbCfHFRHbHSBHFHRRbSHHCRfBFfCHRbMSRFSbFbM#
#bCBHCCfbbCFMBSRMBbFRbFSMHSCBCMfbSRbfbbRRfBbSfCfBMHfbSBHBbHCHRSSBfbFSfCFHfSSbSMbCHFSBbMHMSMMMHMSMRb#
#MRCCfSHbbBHBbSfHBFHBRBHfMbbMCbFbBMHHSbbFCFRSBfBHHHSMFSBbBBRBHCBMfBbRbCMfFHBbRCFMfbHRRBRSBMbBBCSbSF#
#MHbRFfHSMbbfSCRHRCFHRSbSFFRfSFHMRfRSMCRfRMFHBFRHfCMHSHffMbFSFSbBRBBMHCBBSfMfffSFHfMbRCFbBBfBMSSCFM#
#CMCSFSSMbSfCFRHHfHSMCBBfSHHMBFRFCCHHHbbBFbffMBbBFBHfSFfbRFbbSRMfSCHCSFRRFBCFfHFSHHRRCbMbBMMCfbfHbb#
#CSFbbRCbCRRfCffCfSBHBCCCCMbHBfFRbMMbMHfSFRfCMCfBBFCCBRbBFRBBfMBRBHMBfHMSHRFHSBbRFMfHCfRbFHHSHCSCSB#
#MfRBRCfFfHBCBBRMfSRFbHbCMFMFfHFbBHbbSBCbSRBFCMSbCHSBCRFSbRbFHbFRSFFHffMRMBFBRMMSFSFCHMRbHCFBCMBRRB#
#bMSBHSbFBSRRRFHRbFRBHBCHBCSbMSCRBCSfHBCSHMHRfRFRHfMCHRBSHMRBRbFbfRBbbMbbSHRRffMBCRCbMFFbfBHfHSRMMb#
#RCSbfBHCMHfSbMCSfBCSSRbfFSBFffbHCCRBSRfMCSHSHMSRSFRfFCSCBfFfRCSRHCMMBbHHFBMMMMMRMCMbHMBHMFBbRHBBMS#
#MSbFCFBMFCbSSfRRCSSFBBMHfHRbBbRBfFbSCHHBBFFRbHRMSSFBHMHfBHRFHFSSSbfCMSRHHBRMBHBBSCBRMFfSRfFFfMMRCR#
#MffCSfCCBSCbRSRCbBCCMHBRSffBbFHMFfFbfHFbRFbbCMRbfBSRRHRFHfRMfMbFCbbCHFMCFbRBBCCHfFFMfHbMfSfCHCbBSC#
#RRMBMbBMfHHSSbMMFFSMfFCRSCfHRbFHMffSMSBRRBSfSSCBbfFHCSMBRbBMFBBRHRbbfFbSCFHRCbSHbCBCFRHRFCCMHMSMSF#
#bFCRfFRCbMCMBHFRBRHSHRFMRCFFSBBMMBfRbSbCMbBfHFRMbSRRBBRMSMMMSbRBSFSSMfCbBMFCBFBSMfFSbFMfRSSFSffHHC#
#HMFbRfCHRCRMMMRRMfSFfCMbFFBFRSCFbMfMFFHMbMSbbfHRfHSCfFMSCCRCbBfFHSbMbbSMCRFMHFSbbFSbRbHSBfMSMfFBBM#
#bfbbbHBHFffRMHRfHRRMbfBMSRMFbFbHRSbRFSBfBHSHbBCHfCSfSHBCSMBMCMRHSfSFFRMSCMbCSBBCBMMbMfCCFMMHHRSCFH#
#MbHCHHCRbHBFFFHfCFCRfHSRRfMCCHBFHbbHfHffHbbHCHHCRFfSbbSMHBMbCSfHSfHBbSMHSSSSRFMHbbfMFSSCHbFfHSCSFC#
#HSfbBMMbMHRbSHBBfRRBSfbfRMMBFSMRbFbbFfBffSFfCbBRMFRHBCbHCBCMFfBSBfRCRHbMSHbMHRFbMCFCSRbCSfCSHBfbCH#
#HSSHCSFBfRfCfbBbSSMbbHRMMCHRfBSFHSHCRHHSBFSMSbHfSMFMMCHbMCBBfMRSHbCSFHBCRSbMCbMFMHfFCbbFbHSFbSHCCf#
#MSbCMfbBSFSSFCHSRSFSfCfMMBRHFFCHRSfBfSHMRFMBbCRSHMSMCBSFFBbHSHbCHBHbRFMHBFSFFMBfBfRRHHHMCBSbHMFMCB#
#HRHBMHHCBFHHSCBRHbffSSRFMbFBRFHFbbHbCBFRfFRHSMCRFfMHCbBMBFRRFRbHFSBRFBFMBCFMFRMBfFFMbMMBFRbRCCCBMf#
#RMbMfBSMRfHfMRSffCFHSbbBMBCBSHFHfCBHMRCbHSCCHBHRMSSbFRCRFfMbCBFSRCCMMRSfCHBfBBbHHMFCBFBBFRfCMMHHCB#
#MRbFRRFfHHSMFCHCCbHHCbSSRbSRHCHHFfCMBSHFMRFfMFFMCSHHbHSbSFFHFRbCBMMCfFMHBHHbFMRHfMCCBRMHbRHRbBfSHH#
#RHMSHBFfCBbRbSBBRSCHRHRHCSCfCHCfSSSBSRMBHBRMbCFBRffFBMHHFSfFHMfHfMRRbFSSRBCMfHFfMMMSSSFCfBHbFMfBbC#
#fFSbFMBFbMMFfMSfSfBSRFMHCHSffMMHHfSbMbMSBHRCfRbCbHRbBRSCCMbRbBBMfMFRFCCCfFfBfCbCHFFBfBSRbRMRbHBSFH#
#BBfBMCFfBFBFRMfbRMbFSFSSBFRRBCBSBbBfFfFbMHMBffMCBFHRCSffFFSFRbHFbFFBHRCfRFCRMMBRCfSFbHMMSBMRMFBFFF#
#MFCRHRMFSMFMSbCMCMFCCBMRRBfbBfRfRRBFBHRFCFfSFMbbHfRRMHbMRSfBFHHbHBSHBFRHfHSMbSbMSFHMSbCfHSSCMCCbfM#
#bBSFfMRRFMHbMBfSSFFCFMBMMSSFbfRFBbSfbHFMBHBbfSfCRFRMSFFCMBFBSHSSRMHfCSRFRFRSHCBCFRBRSHbCfSSSMBCfCC#
#FFMfbbbCMBbfSSbHfMMHbSCRCfbRbHFCRHfRMFbMBRRfFSfFbSfRMCMHMHRCSSHfMCHfRfFfFFRfCFBfHCCFSRRMRRCMCfCHfR#
#FbbCMHFSCMRfbSHCSHHHbMRbRRffFCBHSHBFRBMbFRbRSBfffBMbBBfRHFffRSCBSHRMfRSRFFRSSFfHfbCSbMfBbMBMSCHbMS#
#fBFBHbHSSHFbFHbFFfMRHRbHFHBHHSCRHBCRbCCSfbbHHFCSBSHbCffHMRHBBSFHBSMfSMfSFMCfMfRbRBMfFbCSRHMCMfRCBB#
#bbSCMSCSHFCSBBCHBbbRRCHBHRbfHHHSFCBRCbSRRSbMMBMRHHCCbSBHMRRbbHbHBMCMBHFMCBSfRbMMbMFCCHfFCRMFBSRfFF#
#CHBSRRfMRFRMSHFSbfFHHSFMHfBRCMFRBHfHFCRRCFfFRRffSbbbbbCbFBFHCMMSFRMFSRMFCbFFCbbBFHbHFFFSbHSSMRFbFB#
#RCFSHbfbffFMCSHCbfCCFbRfBfHRRSHRbSFFBBRMHBBSHbMHRCbBSfFBBRFfMbFfFbBCCfBFSBBBCCSSMFFCMMCfHbMHFCffBB#
#bRSFCbHMCfRFRRFRHFFRBffbHFCRBSBfbFHHbHfHFbCBBMfSbHbFSfSfCFMMffRCRHRHRCCSFBSfCMSHBMFCSMbBCCHSRFFFfH#
#SRBFRbCFCMRMFFSCfMFFBRbHHBfbBBRSbRBfMSSCCBCBRRHFMMBbMSMFMFBRCMHCSRHbFMbfSFMbMSRBfBCRBSSCbMSMSMSBHf#
#RSFHCMfRHHbSfMRBSfMRbHRRFCbHfHMbRHHCBBHRFCfRbHfRbbbFfCbMRMMbRCbHFFHbbbMbHRHbfSMRHMHHbSMbMfRfMRFbbf#
#CSCFRfMMFRCRSfCMbbCbSRFfRbFCMFRMfBfCfSfHbfSCCBbBFMfCCBCMBBMSBfMFFMfSCMfHMFCRRRRfHSffMfRFBfRfMbFMRF#
#RfbRMRRBRSCSSMBBHHCFHBBCBBHCBbfRMCCHHSRSFMCbRbRCFFfBSFCFFfBBCbCMBFCBSFHBbfCBffHFBFFHfBRbMSFCfMHSMM#
#bMBSSSBBCMHbBMSSHRFfMSFbHRMRRMBSHFBBbCFCbfSFCHBHSRFHFRbfBHfHCSMfRFbBBBFSbMFCBFCSbbBRCBbRFbbBSRCSBH#
#MCBfMfSMFRFBFMFSBbCBMbSRBBCBSfHHFbRFRHfBMCRRFCMHHSRRMCCCFBfBMRSBFSMMBFFMBHMbMFMRFBCBbbMSfFRCRMCHMF#
#MFRSBbCbfCMSRMFFHBMMHBffSBHbRHbfCbCCSRMFRSRfRRfbBRMCbFFMRRbRHCfSHMfCSCFCFMSHRHFRbFMFSMbfRbFRFCfBRf#
#MFRFBRBFFfMMMbbFfCMSRbHCbBFSbMRMfSHSSCbbbBHMMCFbfSRHHMfHRBSHBSMfBMBbSRHMbSHRSBfbBCRMbFHBHMRSCSFRSf#
#RHHCfBBCHMMRRRFFbffHCFMHbRFFSCSCMSSFCFMfHfSHMSRRCFfMMRHRMHSRbHCbRRFbRFBFCHCSRHfSfRCCbfbFSBRRRFCRSM#
#fMCSCMfbHHHbCbSffFBFSRSBBFFSBfRCFRHHHffMBbbHBCRHRSBFBFBSfRFFbbBfFfSbBMHRbMfHCbbRBHbFBMRMbCCCBMBfCR#
#HMCMMHBRHBRMCbHFBHHCHMRHffFHHBBMRCffHRbBSfCfBCHbSFSRCFbRBHFRCCBRCRRFHCFRRRRRfRRbfFFFHbBBHFRBBbfBSS#
#HBMfMfRHSRCbHHBSBMSCRCbfbMBfRHCfMCRRBRbCMBBMRHSCBHFSBHbFHBBMSHBffCbMCbSFfSMHCSMHBSBCSMbMfHFBCHSbBM#
#RBCBbSBHHbCBbBCBbBCRMFbHCBFFbMHRfCHSfCSSbBfRbbfSMCSHHBBSCfMSCFSMSSfHMFbMfbfRfHbbHSFBHSBHfSFfbCfCHf#
#fCBRRFFHHbbHMBfSBbbHBRMRRRMfHMRRFbHFbbbMFHSFbMRSFFFMbHbRCbRCCbBHFFFHbRMfRMFMCFSSBfRbRSRbfbFFBBbBBR#
#FfCfFBbCCfbCHSfSSfBfHSbMHCCBMbCSRfMSSfRHfHRFFFMRFFCRSRFBBFSMMSBFFHHCfRHSRRMbBFMHSbMFHFCbRBHCBCBfbF#
#FMBMBBFMMHMCRFFMHCRRFRMMBbSfSfRRbFSFRSHMSBSCbFHBCHHHSMMfFMHHRBSFSMfSSBMFMHRbffMfCfCMCbMMCFBCfFFCRH#
#FCMbBCfffbCfRbHfMfMCHMRbSRFbHbBfFbbSFHFMMCRRFMRBHfCMBRFCCFbHRBCFBFRRCHbHSFHCSBBCCFbHfbCMSbCSFFCfRH#
#CMCCCCHMMRHMFBHRbRBMRbbfbbSHFSMbSRCFbMSSRSbRbSHBBHMbFRRFRHBSRbSFRHSbSBMRCSSBCHRSHSMFfbFFFBHHfCSHBC#
#CHHSHMMFMMfBBCCbMSCRfCBBbCCBMBHHbCfCMCCfbSbHBfFMfMRMCCfBRFSBBBCbFHRRRffbbHRBSbFSfMCSMSCCfCHRbCMRHC#
#SSHRBbCpBbSRBFHfFCMbMSFMMCCCCCCSbHCRRfbfMRRbSCCCffSBbFFFSHFRCSRCffRCbHBRRBRHbRSRCfHHbRBbHMMCSCMHRB#
#HbffSbCRRFCfFfRMfbCbMbfbHRRfFfCCSSSSMRfbSCSRbFbRFFBSBBCBbHHbSMBCFCCBBHFRRCbbBfRRbCFRbMMBRfHSBRffBR#
#BBSHCSFFbHbCfFbMfBFfRCRHSbbFMRRBMbHMSHbBFHfMSRfFBHHHHfMbCHbfFbCHSBBCCBRCFFBBBHMBSMbHSSCbHSSMFFSSFS#
#CbMBCRCbHFSbBMFBSfRMFMRRSCRMMBHRRCHFMbfSHHCFMFHCSRbCbBbSRHBBfMfBfBBSMCBRfSfFMHRfHRSHMbRRRfMBFHffFC#
#MSFfHSHbFMCFFMCHMHFSBfbCFSHfbSfBRRCSCfBfBFHfHHFBSRSBHbCbCRHfFSMbCfMbSMMHSRfbCBFMHMMBCCFbHSSFFbCSBf#
#MMFFBMSbRbMHSfSCFbCMMBRBHSbBSCbRfBbbCBbMSbfBBHBBCfbHSMSCBfFFCfSbCbfSMfHRMbfbHfSBCfSbHFfbMfHbCBHCCC#
#FfBMfBFRSRMCSMCBFbSSCRfBbBSSfSBSbCfbFHfbHBbbRRCSCSHSCbSHRSfSRCMMSCfbHBCFbBHRBHFCCCHMfHFHSCFbMHBHfS#
#RBSMRCHMHHFBFCRMHSffMSFMSSCRBMFbRFFfCFfFCfCbMFRSfBCCCbMMHfHfMbCSSCbbBMHFSCHbFHRBBRCFRbbHMBSBBHMSFC#
#RMbRFMbfMBBBMMSBCSHCCHBRCSFSRSCRMMHffRRRfSbfHMMFbfbFSRBfRFRFMSBHFbBSRBRMfSRHbCHSMMffFCFBfRHMfHRMHF#
#FMfbBfFRMfRRBHFfRRRMHCBCbHSBbbFFRRCSMRCbMFCbBFCFMffRMfSBCbBRMMSMbCBRfCfMffRHfCMbFBSfFFHfFbFHMCRSbR#
#MCSHMSMBHSfCRSfBfbFfMMBFFFfbFRBCBbMSCRFSFMRSbMSFFFBMfbRRSBSCMSBBSBSfMSMSbbSbfRRSfFMSCSFffbHFbMSRFF#
#MMBBbRfbCFbRCSHCbRMCbbBHfSMRbHRSCbCHSbbSHBRCMCBSHRfSfCMffRfCHFCCHfHFHfMbfMRBfCHSBMBbRHSMFHCMbHCSSC#
#SRfBFCfSfCfbMbHfbFMBfRSRSHHbCHFBFfMBRHBbBHSFFFRMBSBBBRSfbRfFbfFHSMfFCFbFfCFfFSBFMBSbRRMSMBBSSCFSSS#
#MFRFfbBfbSMHMMfFbCRbSBbBCfHbSbMFbMMCbbSRBSBHRbRRBHBSRRfFFBMbSHbHbCBHbBMHCSfBfCbCCfbfHBSCSMCHBfHSFf#
#MMRfBHMFbMHRHRMfHFFCMbMMMMCBMbRCSBHMFBbBRbbfBSRFCFRFHCfMBRRMBCFfBbFRSHSbbbCbSFCCMBHRBMHCbFBFfCHSFf#
#BBHHFfFbBSCBFfHFBFCBCHRHHBFHMRMbHSRFbFBSbRBBCHFFfFRSCbffCHbRRHbFRMMSRFBSRffMSRFSHBHMfFRRFSCSbCRfCC#
#BMHRCFHFBMfHRRMffFFMSFFCBHfHCSCHBBRMfCRHCSSSCMMBBbRMfBBbBCBHbCbbFCRFRCHRbRBCBfCCBCCRCBSBFfFRfSCMbC#
#RMbHFMCFFRMHMffSSbSCSMCFMHRbfSCBHbHbfSBMBHfRRBbCHfHFbBCHBCHBRSMFBbMCSMMFCMfCMRSSfHBCHRRMFSFFHCFCff#
#CfbCbRHbbCHMBRbBBbfbCHCFHRHHMBFFBHSRFRfRHfHHFfMFbHBbRfFSMCMRHHBFHRbMBHMCCRSCFBFFHFRHfFCCSHbbfMBSBb#
#BfHBMFBBMMBCfSRMbBFbRbfBMSfHbfBMFCBfHCffbCRfbbSHBbbSHBMbRbFfSHSHBHRFMMbSBSRbRCSCFFFFRCSFfCfRfBbCFR#
#fHRHSMbbHMSSRCbCRBBSMFfRMCFSbRBCbfCFMFMSCbRfMFCHBMbRbMCHbSCMCbSbHMSBFCbBRCHSbHbSfRMFbHMFfRCBFfBBRF#
####################################################################################################
