####################################################################################################
#CHMRRFfHMBHHFMCBHCRSMfCFfbSRBbCBfHFFRCMbfffCffbBfSHMRbCbFCSCfbMMbfMFHMbRfFHbRMBHFMSSbbFCFRSMbRCCBM#
#SfMRRfbSBCSHSMfSffFBSbHRSFffBRBHRfMCbBRfBMbbfHCCfBMbHBffHSSHHCbFFbfHRHCCfbCCCMSFfFMRFbFFbfBCbBCRFF#
#bRbBCMbSFCbfMbfSMbHbMBHbCHFSMMHRSCbbMMFfRRfFMMfbCMCBbMSMCFRMFCHRBRfBRSRCbMCRBSSBHfCRMFSFbSBSMBHCRH#
#FCbbBSbFCbbRMMRbHbbSBBMFRCFMbMRHbffSFBMFSSCMfSHSfRBCRfHRMRRbSHCHSBFCSfFbSHfCfCSCbHFfBCRFBHHfBFBFCC#
#MCHSMFbMMbCMCRffSHCbbfBMbffMCffMCCHBBCRfHCFSCCMBMMCBMSBMCSMbfFCFBBSCRFFSSMHBfSRbCfbBBCMMRMSRRBHCCF#
#BHBCSFBSfFMfFbfBbMBCSSFMHBRHCMFMFBBSSBbFHSbbSfSSbRfHCFfRCRHRBbMHbFSbbMCRBbbFSHMHRHMFfSFCCHBCRMRfBf#
#RFBCHFMMRMCCbbFFCfBbSSRSBRCCbRFBBHSCRCRbfbMRBfBHCMbCFFBSFbHfFRHfMfMfSCfFSHbCMFCfbFBMSRFCFBSfRbHMbS#
#RHHHMMFCbRBSMMMFbCbfbMMFffbRRfCMCSRMBFCFCCFffHSfCBRfMMFBFbMMBbBbbMCBFRMfRfCfSbbFFBCHBFfBSbbFFSBFMM#
#CHSbBCMFFBfBSbbMCBfRbCBMSFSbfRCBFFSMSFMbCSFBFBCFSMCFHRMFHMCfffSHBMHfRSFFfRFRHCHMFMCfBRFbFRCfBHbbbf#
#bbRFSSRFRSBRBMBCbMbSbHSMMRCfCSHSCHbSbbRFRCFFHFMHBFFCRCMMCHRfRSHfBCRRbbMBSHfRMFbSRFMHfffCHFSfSBSRbM#
#RRMBRFSBSBCRBHMbHCBfHSFCMFSHMRSRSfMCRCSHMbBRbSCfFBfRRFBfBMRHbRSMRRHfbSBMfBffRbfSBCMRFFBffRBFffCHHS#
#BbffbbMCRbRRbbHBMBCBbCfBfbSCbSBCRFBSCbbMBMMRMffSFHFRbFbfHFMbBBMbbHBSRFCCfRCSBBMFBMMSFfBSCSMfFHMbfB#
#CFffFRbbbbfRFSfCHSbMfSCMbCSFRHbBMHbbCSffHbBSFSHMCFRbffbSCHbCHCFSbRHfFbMSfFFMFSbSSMfSHHBBRSHHRCfFFS#
#SCbFCSHffBRRMMMbHHRMCFRRFBRHSRBfFBCCCbfCHbFfbRSBBMRMbMMSBfCBMSCBMMfMRbfBSSFMCfSbBCHFfFRCbRbCSRHCCB#
#HMbBfRCMFSFMSCRRBHMSFBCbMMCMFRHSHfSfBbBHfSSFRMRBfRSCBHBFCCbFFbbMHHFSRCfSfCSMMSSMRHFbRbHRFFMSBbCBHM#
#HBRHRSMfBRBCFFfBSbRRHHfMCBFFbMbBHHRMRRFbHRHHMBSFSRSbRSSFRSSFBSSFbBBFbCMBRMbFCfbMBBRbCbBBRfbfFRBCfR#
#fHMBbSSfffCFfSBFBbBfMRSBbFHBbBHFSbFbFRSSFSfBSBMSHbRbfBbBSRFfRCFRHfRHFfRFMHBBHfbMCCHSFHBRfHBBBFBRFM#
#bMCSFBMHFCBBffRCCRMSfFBFBbRMfBRSbHHMMSbMCSSBBRfbBFCSfRbBCMFHfHRHfHBbCHHbCffFSCMRFRFFbRbFCRBMRFfbFR#
#FbbFffSHMRHMfHfSfbFRCBCfbRSbbHMHHRFRSHHCbHBFMbRbfCHMbCFRBHRCSHHBFSHFMRRBRSBBRfMfSCRSRSRRFSSbBMfbfM#
#HSBBFbbMBbHHCfHSFFCfCbMfRSfHHMRFFBMMBCCBFSFBRRBCSSFbHMMBbSfFFbCHFHFCCbbbFBCFMFCHRMCCHFRCCBBFFfHSMM#
#CHMbfHfHbFMSMSFSbRbBSbMBCSMSCffbBCMBRBRSMHfMBRfCbMCMBHRCHFffSbMMSbHFMFRMCHRHBbBRRSSRFbBBfffHSHCHHR#
#SfCHBFFMbMBCCfFRfFSbSfbRSbBHFHFMSbfSSbMHCfFHbbHRBSFCbFMCfMBFHbHbbFSHFCBFfBBSbHFMFMFbCbMbfbHSHSRBbC#
#RRbfMfBCfHMfffCBMbBRCHSMFbMCfCMfMHSbbFBbbBCRRCMMMMRBRfbHbfHfCHRBbSSRRFHBFFfFSMRbRHCbMCRFBFMfbHFMSb#
#FSHfbCRfBBfRfbbBbSMSSSSMCSRbHSHSMCBFSFMBfFMRHfBMFSBFHSHHRBBBbFSbMMFCCHRFbBSFMRSHBbHMffHSMRSRbMRHSS#
#FCRfBCSbSbbMMFbbFfSBFBbbBFFBRMMRCCFHfSMRMMfbRHMSfbFFfMBSHMFMHRSFCfbBbSRFbMRCSfCbSFbSFbMCFCMbbMFRMM#
#MHMFFfMSMBCfCSRRbFHbSfbHBHCHMbfSCRRFRbSHMBSRbFMCbCRHMfRCSMFHRSFFbHRbMHBHBHfRffBHRFFCRMBRFRSCBMCCSb#
#RSCFHbfCbBbSCMRFCRfFbFRRMffFfFBHCHbCCffSHSbCMSSMRSFMBFFHRRFSRCBSHMFRHCBBRRSFRBHBMBCSCHMBRRRRbRSFbB#
#HMBSSFSbbSRHSBfSRBFMHBRRRHRRBCRbRMHSfbbBfMFbfbFfFSbSbfHCHRSMfFfbHbFbRCSMBHfSBfHBfSCBSfMCMbRBSbSBbH#
#MFHfffFMSfCMRCCSBCFFbBFMSFCMfbbMCBBbCHHSRCbRMCFBRSfCMFRCbFRfbRMSSHCfFbHfHHFfBRbbBffbFbfSbBCSBRHbMR#
#MFbMBBMMffbRBBbCfMHRbHFbfFCSfFBbHbbMBFMbFHbHMbSMSHSCbfbMSMFSBHRSMbRSSFbCHCbBHFRSRfMbbSSFSffHMSbMfb#
#BMSHRHRFCbSSbFBFFBBbSRCbMSSSRSfBfFBBfHbbRBbFCRSRMMCfbBBMHCHMfHMMMMMbHSSMFSFFBbBffCMRfCBCSMHbbSBfMF#
#CRfSSfSSfBFFCFSRbBSCFCRSHMSBMMBRCCfMSRHfMCMSbFfbRHRBHfBBFFBHBCBFbfbHfMFCCRRHRHRfFbFSHSfFHMBBRfBHfH#
#HbbSBCSBHRMbSHCCRMCFBFRRRfMHCMHffMBRSbHBBbHMMRFMSRBfMSHHbMbHFRSfCBCfMBHMCbfMBFMFbfCBSRMCfCCMHHFFHb#
#CbBFSMFbBRSRbMSFHfMRfSbbRfFHRCbMHSBRFCfHbMMBCSHHSbBbbBHMfCMFMMSfbHbBFbMSRFBHbSfCMFBMHMfbfCFBFbfbCH#
#SMMSCCCRfCHFCFbBRMCCMSHfCRCMSMBFHRHRSbfCSFSMFfFMffbCCbbHSHFBRfRCFSMMMRbFbFHCMHFBMbMSBSHRBMRSHHMffF#
#MBSMHCBSRSFfBSMfBCSbBSRbbMSFCSbHCfbBSHFFffCHfbHbHHHFbBFHHHbBBMBbfCSSfHbRCfBCMFHbbHCHCSHbHbffCCfFfF#
#SHHFBSBSMHFSCbCfRBFHHRRBBSbCHSRRfBCCSHBSfMMMFFSFHSRRBSRbBBFbffFbRHSMHRHfCfHCHCbbRHSfBMbMMSSCbFHRHR#
#BMSbfFRFBSSfCHBCbHFMCSRCfSbCSCbFSBbbCRFHFRHCFFfCbSbCCfbHBHSRCFSMCFSBHCMCbRbSbMHfCbbHFCCSHRFfBBHCFB#
#BFbbSfBRBMCbFCfCCSCCMCMCbCCRSfRRMbFbHHFCHbbFRMRMMHCMbMCBMFBBRFbFFMFMfFFRMFHFFbfRFCSfFSbCbMBBMCFbHC#
#RMFCRRCSbSfRBffFFSCfMfBRHHCMbRbMbHBHMBFbSSSfFFMHRHHMRBFCHbRBBHMBRSbSfBCCCHMHCHCHfbSMMBSfbfCBSfffRS#
#fCbfBHSHBMCRFBFHFbMMRfFBFSbbRFSBfBBSbMMMbFfSfMBRCCMMHCHBCRFMFfHfFfCSSMCbSFCbMRFMFBbHfCFfCfMBbFCHBC#
#fSBHbbCfSHCbSfbfMRRBbHMBSSBfFfMbSHffBCSRRMCHHFBMSMCSMBMfFSBfbRHRfFFMHSBfRHRFfFCMRMMRSCRSffCbFMFRBC#
#bbCRSMRHbMbBMBBSBfSSMCHbRHFCCMRMCMfHFCFRMHbCCRCCSFMfbbFfSfSMfSBFFfbCFCfHRHCfRHBMBfCBBfRMFfSbFfRbFR#
#FMCfbRFFFfBHRBHbHFMfCbfFbfFRMfCFCRRCfbfCBHCbFbCMFbRSfbSMSBfBBbRMfBFFSfSSRbBfBMfBSfCMRCbMFbCffBSSBb#
#HCCfFRHfHbBffSBBRCbRRbbRBFMCFHRRbHbfbHMfRpfBHbCSRRHfCfBHSBRBMRMMSbMbRHbbbHFSSbFbHCBbCMbRCMCCfMFHfS#
#RfRSfSfCfMfCMSMfHRRfHRHbSBFfBBHBSSMSBfSFfFCRMRMFFCCBbRMMRMMSFCbHbBCMFbSbBbHbBFMHMBRMRMMSHCHHMSRCSB#
#MRBFMCRSfCBBfFMRbBMCCMHHbHSfRCbFMBFBBCFRffBMFbMMfSCBBSRFSRfRBBFfBfSBBBRCHRRfBfCHMbCMRFMbfMHBfbFRCb#
#SCCBCSbfRCBMbRSbSMMHCHMMbbMBFHMRSCHHCBbbbRfFFBRMFHfBMRfBfRSSfMSRFbMFbSCHbHRFFFMCHMbMRSFMbMCMHfFbbf#
#SRSCfRFbSbFMbfRBMRFRRFRFbFSCfbSFRCffMSMSRbCCBCCCRHfRSBHRfHfbFBbFSSRFBfRCHbHSSBHFCRBCfSSbFFRHHHHRRS#
#FHFCFfbHBbBfCFbSMRFMfCSMMbSCFHHfRFFCCCBHSBBfBCFBSfbFFfMRHRCSbFbBBCRfSbMRbbMMfRMHMHfSSCCHFRFBffRfBC#
#RFbSRfBSHBFBSMBbCHFfFHSCbCbbbCBRFSSCfHCRSHRHbMFCBCRBfRfHMBfMbbRRfBBHSFbMMHSHBHSSCSfMCfHSMFSBMSfCBH#
#bFFCbfffRfCbBMHHSHMSbHfBRRSRHRHHBfSbbfBRSFCBfRbSfBMBMHMFMSbFfRRMMRBFHBMRfMSHMffbRSfCRBHMfSFfCMFMBS#
#SSHCfMBSRMHbFRHRFFMFFFfFRbBFRRbSRCFSBRMHRRBfHbFFBFMfFbCbBffCBCCHbSMFBbMHRCBbRHBMSMHFHRSSfBCFCFSfSC#
#CCbbffbFBSCRHHbFbbbCCRFRHRbFffRRRFbSfRRHFfCRBHMBSMSfHCbSCBbSSRbHRCRFFMbbFbbCHMRFfRRBbHbbMMHFCFSSFC#
#MCBCSMbFSBFbBfSHSbMCfRFRMHMSFMbFSHCCCbMHBBbMBHBbCRRSFRfRFfRMCFfMHfFFCfRMSHbBbfBHFHCHRbCCFbRFbBHMfF#
#fMMHfSRSRFfbCCCHRbFRSFfCFfBfBFFCFMFSRSSHRfMHbFCbSSHbRfFFbHHCSbfMFRMbMfHHBCfCSCbfBMBRMCbCCBSFfSSbSM#
#BSRfCMCMMSBBRbHCFbCbRBHMBFBffBbSMMFfRRHHMSSCSBCbfFfSRBfCSHRBHBbSBRRfMRbMfHMMCFHFMRBRCfCHCBbMFMSCff#
#CCFCHRCHFBfbfSSfHbBRbbFFbSfbBMRSRbFRMfSbCMMBHMFBfBMbBRCBHRFSfMfbfBHHBBfCbCHbRHBFFHRFfHMMHFHHMHHRBC#
#FHCHBSHfRCRFbFFbFFMbHfSRHCbHCFFHFRHfBHFfCMCSRBbRCBCHHfMMFHbCbSMMFRMCfSFMCRSMSHSSCBFHFRbbSCBBHBBHMC#
#FSSHSfSHbFHRbRHBRSSHFRfFRBBSMbHbfMMfMRSRCfMRMFbBFHFRHHHHBbSCRCMCBSRMSHBHCSfRffHSSCFRBRbCFfBfSRMfBb#
#RSRbCHHRMCfBHHbSbbMfHHfMRHBBCCbSCbfCfFMFMfBMSbfBMCCBSBSfMfbHRMBCfbHMMbRFFFCCRBfMSMMRHMBRBHBCCMbCMF#
#BBBRRffHfCMHSfCFSBSSMbRSCBSSRHCbHfRCCFbbRFbHfMBRBFCFCbbMRRRbSMRCSfBSFbBbSFBBbbRBMSFbfbHCBCbMfBMFHf#
#FRbCbMFSFHHMRRHbHMbfMbFFRbfBCRbBfbRfCRRHMBCfFFSRFSffbSMBFbfMHbfRMFMMBfbCMbRFBCFFSRHRfMCBSBRRSBFfMM#
#RbFSHRHFHbFCFfMMMCMHHMHCCHBHCCMRFMfBMRSRCBSFBBCFMMRFMCFMSMHMHCRRbfRFMSbfFRCHFHFHFMFCRCBBBMbbFRFRHf#
#BMSBCFCBSFFSMbfBHRHMHfffbbbffMSFfBSHCfMFBbMCSCCSRMFfBfMMSbSBbHFfHfCBRCCMfMSFFFFSRHHFCMHMbfBHffCHFM#
#MfbRHMCRCFBbBCRFCfMRRHFBfMRBfCHFHBbFMMbRHbbFCbCfBFRRRFMHbRFHCBSFfHFMMFSCBMbHFCSBRHSbBSFBFRBCCSfHRb#
#FSfHCBMBbBCCMFSbSSFCRbFMbRSCRfFffBFMCBbMFRBRFBSSSMbMCMCCCSfRCFCMRSRbffHRRBRbFfMFCHBbHSMMMFMHCRBFMf#
#FBSBCHfCFCBMBCBbBHRCffbCHHCRHFSRCHRRBbBRbBRSHHSHRFfbRMHCMFbRHHBMCCCfSSffBfMHMffbBfFCRfRHRMCHMfRSFR#
#fHBMFbbMbHfbSFbRfSBHMfSbSbHFCfSfSbRfMBfBMRBMbSbMfHBbHSfBBRFRbfBFHFRSfbbRRMHSRSHSCffbbSHSHHMRFFFbHf#
#CSBRFRSbbCBBBSSHFSSBSRRbHRFbFFHRMMMfHSbRRCBFbSBFHRHSFfbfSHSHFSHRMCFBbMCBFbFFCRfbCMSHHbMHRCCBfFFBbF#
#HFBCHfHBRCRFBMSSCMbbSHbRMFbBbfFSBfRRHRMMbFBRFFHCFCRHBMRSHfCMfMBCCFbRSFCFbfBSbRCRHFMbRfCbbHbRRSSMFC#
#RMRHRRMMFHMbBMbfRHSSMMHCBFCCfFFHHRSfCBSMHBHSRBHSfFffHSSMHHBRBbSRbMSCSRbbFCbMbMHFSFCRMfbFFSMRbHHBHM#
#HbRSbHfCBfHRSHfSHSCbCCSffBFMRBMSFMCMbMHCfHbHbRFHBMHFCMBCMHFCMRFbbCMSHHBMRSbBBfRRMFbbCCbfMSHFMCBHCF#
#HBRHSSFCBfRRMMHRMBFCRSFbRRfBRFHMHCHSHBSFfMMBBfSBfCfMfMCCbfRCCFMRSCSMRCBMFSbfHMRHbfCfSCCMRFRBMbbRFb#
#BSRBFCSCfBbMMRBBRCHRFfbMSHRFbRCRBMHBRfFbfbBCBSCfbHSBfHbbbMHHMMffRRCCRbffHfFbHCHRMRBSSfSbBfRfMRMSfH#
#CBSSBFSbCfBfFFMCBHbFfBMCSRHfRBRBHHfHRfSbCRHSbRRfCHBfHCSHHRCBfbfHbSBHBfBMMBRbHSBSfBSHFHCBMBSfFMBFBR#
#HCRFMSSSMbCMCFFSSbMRSRCCFfBbbfHHfMHBMbFRSfFbHBfBSCbCBBRMfBHMCHSFFFHRbMfbbfSFCBHFSFHfHRRSbHfbHRRffR#
#HHfbRFSHMRfFbfMCHbSbbCHbfCHbHSbMBbHHCfCfHfFfRfMFRCbCBMRbFfHfRFCMbfFfBRfMHFSRfbFMbBBfFCHbRBFFHMCBbS#
#SfBRSfBfHRMCRRbBFCFbFffbSCMSSHSSfFfMHRFSFFbHfbHFHMMFHBRSFHCMfHFCMRBbRSSCfSHbMHbSfRSMCFFHMRbbHRFRFb#
#BHCfBfRBCHCRRHRRMHbBFSHRHMHHFMMMFHBRfHBBCbCSSCFfSRMMbFfMSRHFCHfHbMHbBMMSfSbbbRCBBfRHMfCFRbSFHSMMBF#
#HbRbMFbMRfSFBCfHfHSFbBSBHRCbfBfSRHMFbRbRSFRMFfHbCMfFFfSHCbfSbfffRbSRFFFHbBFRfFbMSRRfSRbSbbMBfBCbbC#
#fMRBMbSFFBHHfFSBfFCBSBFFHSbRSBBbSHFHffMFfMSHRSBbRRCHMFSSCRFSMCCMbbCbMRBfSFCbFSRCMbCCbbFHBHfBBCRbCb#
#FBFMfMSRfHRbMBfSHHSBfRRMRMRBffCBRRBCRRRRSBMMHSBCMCHFbCFSFbbMBFRBfFSCMHSffCRCFbRHCFbFSMHRbfSCfRSBCM#
#HSfbBCbRbbSRSMRbCMbBRRBRFfHSbfCHHBMFCSMMSRHbSRCSFbMFSHSfFSFFCMSSbSMFbbHRFHRfFHCRMRMHRfMfHFCbFMbMbF#
#bfFBSBSfffSSCMbbSMfHBHFHffSfCffSCHHSRbFSCBMfSSfRfMFHCFCFBfbfFBMSbFBBMBRfHCBfFHfFHMfCMHfCfMfRSCMFFB#
#fbFCCMBBFFMRbBBRFSHHBFBSfRMFMBHMfMfFHSfRfBBCfMfbbBSBHbfFMSffBSHFBFBCbFMMFBRCRMMHCSCCMBCFCFFHHRSfFS#
#BbMbMRHFbbbBFSMRbMFHFHSSHBMFbHffbHfHFRRbRRCbfbHfBfHbbMCfCfHCRSMbbHfRbCRSHCCRHfRRBSFSHBbfSfMSBSFHRf#
#fFSfHfSMHSbBBRbHbRBCffBHSfSFCfMbBHRfMfRRBCSBMSFFSCbCMfbRRMfHFbfbMCbHFBHFfMBHMCRCCbfBRMbbfFfCfCfHRB#
#BMbCHfFMfCFCFSCBHSbbBbBfBfbHCBFRbRBRFFfCSMSRfBMCSCfRfHRMHbHFfCHMFfSHRffBBCCfFbCfBFFFMCMMBMHMRMBMHM#
#SFSRRCSRMBfFfHRSFBBSCRMSRbFSRBRCHfHMFBSCBRMHCHHHCHRFSfSMfHHbbbBBFHfbCbRbRBBBMffMFfBBSSCRbHSRBCFBbR#
#SHFBbfCfBBHHCRHSbHSCSMBSSSBfCCfFfbMfbMCRCHHbRBMHSCSfRBSSfSBHSSHfMbCfbfCMFHCRMRRRfCRHFbCfBCfSSbHMMM#
#SFfHMSBHSfMFMSHMfHMHRFbBSBbRCfFRRFbfMRFRHSHBBRffSfCRbCCbSbCMMCRFBFbbHFMHSHRfbCbMCMCSSMBSHHSFSBMbBf#
#CBCbRRHMSRCfCbRFFSfFbCCBfCFSfFSHBBfSFCSfBFHMRBFBFbbCMCfSRRSHRBRBbCMRCCRbSRRFBCbHMFCBHBbHMMffSFRFHH#
#MfRSBHCBfFMbBffBMRHMHCSHFBRBFfMMCfFBMMMfBMRFCMbMSBBBBSRHRffRRFCBbSRFCFMSBFHbSFffHHbbbRFSMHHMCSFRHf#
#MfRCMFMRHfBCRfMHfMCbCbCCCFSRRFSCHMHfMbSCbRRbSRHbHCMbHCbRHRFbCBfHMFMSCbHbCRfHFRHSCMbbRRMHSMMCCfBFfC#
#MBbRMFMFHfSRHRMbCHfBbSbHffHMCBFCbbFCffRMCBMRMHbBSBFSRCBMbBBCFMHRSCbRfSRSBSBFbFbFbfMRCBBCSHbbfHfSCR#
#ffBMSSCHbRMMbbSSFfFMbSMRMHSFMRfSCHMFHCRHfbbCSMRMfSFRRbFfbBMRRRRHBbMBSRRMbfRMSHFbMHMFBCFCHCSHHfMCSf#
#bBSMSSSHSMFCbBHCMCFCCBFFBCBCRRSHSCFRbRFSMfRRMSSbRHbFFBRbHHCbFMBMMBbMFfCCRFRHBRbMMfSbSFRMfRFFRHbSHS#
####################################################################################################
