####################################################################################################
#VHRBMbCbSSSRMCMCVSVfBSVHFFVSVfCMSFFBBCFfBHbHMffBRbRMCBfVRbRCSVCVHfCRfCBbRbFFCHBSHRMRVffMMbfSMbSBff#
#BFBbSCSHCHCRVHBfCFfMbSMMSHfFHMHRMCfMRVVRBHfSMMCVRbbCbMHBRRVRFRFBMFVSfSMfHSMSRfCMRCfbbRSMfRFbFfBMCH#
#FbBVVRbbCBFSBHVFVMVBBMHSffVRHBFRHRCBCfCBHRFHBRfCbbFFMSCCfHVBHMbVFHfBSBBfCSVMFBMfHVVVbFMMfBRSHMBMFb#
#CRfVVFbBBRMMBHFVCFVVfVCVVVVMMCFCHRHfRbfCHbRRSVCRbVHCBMRfFSRHHSRCMRVbHfRVBSBBBMCSVbMVCRMCHfCfVCFSBH#
#SCFHMMCHRCFRbFfMRVSVfFMBCMSBFfCVSSCSRFbFVBMSSVVVFfMRFVCMVMHbCbFMffCSBVFSRVBCHCCRRHCFMHRVSHFFbfSCCC#
#MBHCbMBCbCCRfMFFSFRbSRVCMfMFbSbMCRFBCVSHfHMMHBVbbSFbVVMVbCVbHfFFFfRBCVCbFRMCfCBHMfRRCMVHFFSSHbMRHV#
#BMCfHHfHCFBMCHfFSVbMVBHfVBBHfFFSMRfMfRMHSRBbBCFRbFVCVSHffBRVHHBSfMMMSfHBFCfSbVVVBfbfSfRMSfMMfCffVS#
#MCSMfSBSfbFRBSCFMFHbHfBbBBSFFMHRBHSfMSFHFFRfFBFCfFfbbFCSHVCSSbSBfbSfffHfSCfFfSHVfMFFFCRfHSbMFbVBCf#
#SRBbHSRFHHHfCbSFBMVfBRMbHSbRVRRBBRCRVHbRbFBCVBVBSSSMHVMfVBHMHVFBSRfHHSbRbFRCFFHMVFRBRfCfRSSMbFFfRB#
#SCVHSBSMfSHRMRHMCBMMSMCVfSBSRMBSMRSHRbVfVbCbBRfCVMbBFFbCSHbHHMRHFVMSbCHCMMVCfBSRMHfMVSFVbSFVCRSFRB#
#bBFMfRBBFbFHMHBSHVfRBFBHfVCfRVBSRbBCFSfCBHBfCVBMbMSCMMMSBHRSFSFHRfFBfRFfHfSfRFSbbfMHHfBHfBMHVbSSRB#
#VRBBHfFCSBfSSRMMfbbBHfRFbbFfCBbMbCFfBbFfSSSFbHHMHCBHbbbCCbVCMHBSHCBRbbVHFMBbVCFCBSRBFMMVfVCBMfRVCR#
#CBMSFSVMVBbMfFCMHFCMbFSfHHMBbHMCHMBSHfFHMCHRBBRFMHCBfHSCbVRVFCCBSCCFRBBbFSfVFBHFHMFBVHRCFMbRVFHFRM#
#bCCfRFCMRVfVRCMbSFbCCbRCfCFbBRVCVRVSHHfHHSVMMfbBVbMVVRfbfRbbHVRbBSBRBRRHMbBbCCSbRCfSCSCMVCfSFHffHR#
#HfHHSMCVSbVRBfffSBVFVbFSSFSFVbFFHSMBBbFRbSRbVffRfCVMSFMVfbbMBSSFVHVSFVBSfbVRfbFSFVbbBMbFBVRBbfCCRV#
#fCFbBFfVSRSHbMRBFMCSBfBCMMfBRfbBCFFMMfFSbBVVRCSRBSBVFHBbMVHMbBfFffSRSSSHCVFBRRBfFFCSfbSFCCBFBRRFRB#
#bVfVCMHVfSSVVFSMbMVMRFCBCCbCHCBffSMBCfFHRBSHRRCfCHfbVBVHSHbMBMMHRMSHFfBSMbFMMRSRVVRSbbRRSHHfFVFVbB#
#VHCCBRHSFFfFSSCMFfBRVffVCSFSbVBBHMSbVffVMbCfCfBfbVHCfVHMRHCFMFBCFfbRCFBfbbHMSCfSfCRRBFHFbbMbFHBbSV#
#CBMRSHHCVSBRSVCBHCRfSSVRBCMVfMFbFHCCFVRBHFHFBRCHfRFSMfbBHHFFfMCVFffMCRSFCRCFHSfRRBBbbMFBVFbFMBMbMB#
#CBRFRCCBCbRMBBfbHRCfBCSfRbbbbBFHMBCbFMVVCCBSCbBSFSFVHRRRMffCCfHMHRfSRHSMffBfbBMMfbSRBfCfHSSfSHffHB#
#HBSSVVBbMCFFfBbVfFRCCHSffHMRRBfSMFBHbRBVBMMBCRbSFbRBSFFHBSMRRbfRbMSbVbVfCfHHCMfbFSfCbbRFVFVRHfFVSS#
#HMbfVfRHbfSMbBffFfCFRbVRMRfFRCSCSMSFBVBMVBMVMCfbFVFHbSfBBSFfSbfRMMfbHbCBCSbBbSfBCbbffSRCSBHHBMfHRH#
#RCMSHHfSRFFHfHCRBbSFfBfbbbSBbFBRSRfFVHVfMBHMSHHfCVVRfbMBHSbFBSBbMCRVVSBbCFFfMRbfMHfSFVHBbHHBCbCVbB#
#SRFCCRRRVMfBfMBRHHFFSVbRCCbBFBCBBRBfBBBMCFBbfBBFFRCfbffMfHVRFfVMMFfVfRCCFCHSCbCVRSbBBVVSMffMFBRMBb#
#BFSVMRCfHVbVBbFMMVVfSCCfSHFHRHSHCCFBHbMVBfBMfFMMbVRSRMHMbCfFbHRVFMBFMbSRVHVbCFRHFSBbMVVHBbBbbCBFBf#
#BVFMFbMHHCHCSFSfbHCRMfVHMMFSRVMFffCCSBFBbSbSCCfCHFVRfSMRbSHMbHbSVSMbFSbVFMVBRSBBRfRFMFHbCCVMbHbRRC#
#bRCHCVbVSfSfbbMBVVSSCCHBfbSBCFFBBCMMFRHHHMVfCSMSffHHRSRbBbFBFFRCVVRbMMSHMSFSRfbRCRfFHFHHfCHHRbSfSS#
#SBSBHRMMBbHVHVHVBbfVbbfMCMRSRVVMbMBBFCSbfbCHfHCVFFffCSSFHBbHbbVRVCVFFCSVMCFBbHCbHFbBVFFfRVMMBCSRCC#
#SffFVHFFBSFBMBfCSHMbRSFHMMVCSMFSFRbHHFFRVMVVRCMCCCVBHBMRMRbRHRbbfFCBFVHCHFVVMRHSMCHFBSRBBbHHfFCfSC#
#HbCBbCbfVfBRHBFFSBBVMRSMbRMCFMFHRCBFFFSHFVVfFRCMVSBFHVCHCCVBHMVMbSFRVMFSCBMRfBMHBRbRVBHVRSVHbHbSHH#
#FBBRCSSHRfBFHffRFRMMBMMCbVbbfFRMMSRRBHCbFCBBbVCBFfVBVbffVSBCSHRMFbfHCHHBVSbBbBBCVFMSCffHSBbFVSRMbC#
#HHbRCSfSHfFVfVHSCRVFSRSRSHCFBCCVHVBBCRHfBMHSSRCSCMHCHMCbCHFFFbCSMbMCMfFVRfCfHCCFCBBHBVCRSVRHBVHBFb#
#HVfRHVMbVVMMMbHSVbRbMHFRVVRCFbCVFbfSCRbRSfRSFRVMbMfFFMfVVVVbHSCBBHFFRSBRMRfbffMbCbMMBCMSFSfBFCHCMF#
#HSVMVSFCVCfVCFbMVSVBVCSSHCHHBFFHVbSbSfCSSMBHFRCRHMRBBRbfBVHbFMfVBVCbVHbMVCCVfbbRMCRMBVFRCSVRbMVMRb#
#CFMRVSRHMBCBfVfBBfFHVFVFHSBbVVVHBSFHCFBRbVHBVfCCfVSMSBHRfMHFHRBCFBbRbVHCbCSfMRHMMfHbFFFbbHbfHBfVBV#
#SHfVVMHHRSMFFFBfBfFMVHRbVVSVfHfBBRRCCFBHBHRRCHBSHSHSMMfMCRMMfCRCBFRFFRBHFHHfSMVbRbVbfCBRbRSHCRfbHR#
#CFVBSHHMRfSRBMSBfRbHCRCVMRMBSbFbbFRMCfffRFMRFFFRCHSbfSVVVBbBVRFSbVCRSRSCVRRbfCRRVVBRRSSbfHRCRMCVFB#
#MBHCRfbbCfMFffRRCSHfSffFCRBfMHfbFHffbCRMMfbVBfHSSRSVVfbSRbHCBCMfMfBFBbCHBCbRBHBMMSSSVFSfHFFbMbfSHS#
#fBfCMVMFCFfSVbBfCHfSHFSHfRBCFHfSBMBHFfRRHMbFCCCBRCBCRFHFBffMFHBFSfFFfBfMCVbFMVbFbBVfSFbbHMSMSSHbRM#
#BHVbBHRffRHBCCCVBVBFHRFMSCBVCBVHMCFSbRBFCVVVSSFfMMFMRRSBbfMHSRBVVFMBBfMbMSbVbFFBBBFbVMSVHbCbMCRFRC#
#bfHBRMBfCSFbCbMBVBRFVCHRCCfVCSRHCHMCHMCMSbMMFFMMFMCHVFffVbRHSFCVfRbbFFRVbHSfSRfHCMMRVBMBfHVVFRHCFf#
#MBbMRVCVBBRMHfRRbBCBVRSMHMMFCCMSHFBfCCbHCFHfSHMfFFVCBfbbMfbMbSCBFbfSFRSFCCMbFBBVRVSCHfSfRMVFCSFVBC#
#FBbRBfBfFBHfVBSfMfCCVVRBHfCSHRMbSbbHMbBSSCfMFMRVMCHfHbVbHFMHCMBSHFMBVbMCVbRBMVHBfMbBVHMMVVSVFMHMRC#
#SMRFSBFRCbbHRVSCfCFMfHFRHbBCfHHfVBSMBSbCbffMVbfBCSSHFFRCBRHCVbCMRSHCVCVBHRHFbSVbMVMbHSSBVfHRbHFFfV#
#SRMRCCFBSCHMVHRBSBHBfRBCCHHFCBbBSVBFHCHRbMCbVBRHHSFSHVSFSBBVVBbfFfMHbHVSbCHRRVSMfRFCSbHHRBFFSRHHFR#
#RCRRBBbbRCMVCCCMHFbbVHbRMRFRVSMVBffMVbRBHCffMRCHHFbHFBVVSCRHMRfBVHRbFBHSbRVFVCFVfMBfBBHMMfSRRRMFHf#
#MHFFMBRVfHCCSfHMSBbCSHRFbHfMBBfRFMCFSSHHHHBVbBSVSbVFBFbVSbBVMSMBVBfVHfRBSbbbSSfFFHbMfFHVFRVBCCSRMV#
#fRBCRFSHMMSSSRRHVFBFBBBfFHCMfBSMMVbVHCCCMFbfSCVfHfSHfSRRHffMfFRCbSCVHSRRRRCbHFfBVVCBVBSCCfVfBSBfCb#
#HBVSRbffFbSVBHRRCCfHMSfSfRCRCMMHSMCRRbSSHHRRfFCFHbfSHMBRRFCVFfHHRFVFMMSBCRMFBFFRVbHHRVSBbbRbRFHFHb#
#SVfCCCRbHfBRHMbffSBRSbfHbVHRBHbFSfCRFfHCSFRbbbBfbFCBbMBMbMMFCFbbBSMRSbfMCRVMfHbfRFBCCBHSHCVFMHBHbV#
#HbfBSRMSfVFMVFHMfMVRVVBfSRfVFHbVCHRRMCMBFSRBCMHMFHbfMbfBMMSMHSBMVCCVVBCHSMRbBCHVFHHbSBbSfMVSFMbRMC#
#MfVRMCHHSSVMbBbCpHSVMbSSMSFFFRMVSSMBRbfbVCbbbSHBbSffSfCFSHSRHHSbRCBbFHfRBFFbVbbBbCRBFBVbVRfMVCHbMM#
#bHRHMFRMVSFfCCMVCHfBFbRFCBFBHHVfSMMMfMSRfCSMFFVSBBMSSRSBBHFMRBSFFCSVRFfSfFHRbVBFSbRVfFMFBMRfbFCFVH#
#BBSRbCSVHBFSRCVFFMSRRfBHCfSCVBCVHHHfMfHSMCCVMFMVCRCBSRMFRBfHHbSVBBMCbVVBfSBFRBSbMFHHCbbbMHBRRCRbFV#
#MBHHfVCCMCBHbFSFSRRCBbFSCFffSFRMBSMMSFMRfHMSFVbVRRCfSHFHFMFBFFMCSfCRSFfBfbHFffRbMbSRMfSHSMMbfbCCSV#
#SCSFFMSFCRMMFHRbRHCFHVHbRBFfCbVHMfRfMHCHHbfbbFFRfBRFffVBbHMMSbMHRFSBFFMHCffRMHfVCSSRMBffHMfbfMFRHF#
#BFbbRVSfFHSRbFRfSFVMFCBCCMfMFBVSHVVRMSVCCffRCBbfHCFBRFRFCCfSHVHBSRSBRMMFMSfFfRbFHHCRMCSbHfMfFVRMbf#
#HRfBMbFVSSVfCVSfSfSRfSCCCfMHBbSSFSHMSVHMFHfCCbbFRMffVVCHCRSfVBVFCRFMVFFVRbBMMMCMbRCVbbFRCCFSVHVRbV#
#CCCFBSSbVHVfbBHCHCHHHBRFVSSSSfCfbHfFfRRRMFRBVFHCMSSVSRFBMRVBfSHCBbbbFSSbBRBCVBRHVRMVFbHCbVBbMfVFRb#
#HRHSFMMBVRbSCSMSVHVMMMVBMHRCffCbbfMVHSVHCBfCBfBHCMBMHFSFfVCMfMMRSfMCFRBfHRFMSVHbBBMRHHBRHCCCMBCMCC#
#BRbfRHCRCfHCSVFffSRSbRfHBfSbMCVCCFfMfRCFBRfMRSRHVBMHCCMFSSfbbSSMHBCRbMHHVBVCMHVMBHbBBVfMbFCfVFVBbR#
#RSVSFMVMRbbFRfVVMMMFCVbSfMBSBbFbVFSMVRCSSBHbMRCfbFbVBVSbHVfHCRbCbFRBSRbMMSMFBSFRMFMfFRbbMbbHFVMHbF#
#MRSfHBSHHFbCSRMHMfCRBFBCHBCbSBBbfBBCfCfRCVSRMMRSMSHfCRfHRSFbfSfMMMFSRCbfffBCRCRHbBBRMCCFHFCVfFFMFC#
#bRbBRRFbRVBCHfFHFBFbHVFRSBFRVFSfVCHMbRFbCCBVRBbfCBRFVRffSbFCCVFRSBBfbCMRBCRCBFfCVfbCRVRfBSMbffRbFb#
#CHSfBBSSVBVFCHBVFVRFCMVFSBSCHVSFfSMRVSSVRBMVSSVfMBSBSfbBRSFMHbSVBSFbSSFMbbFbBCFbSMbMFCCfHRbVfCHHBH#
#VCHBbMFSRSVfRSMfBCBbMMFVVSMfVfSVVHRRHRRBCBVCMHRHHbfSHfbFFfVMbBHMfbbCRbRBfbbHBMfMHMBMCMFBMSRVFfVbFB#
#fMRbBfMSMbBSbfVVSVffHVSVVMVRfFFBVHBVfRSSCMRfCFVfFbCVMBbBFRMMbRfSFfRRBFHbVHHVbMbVVVbVBSBRbbHRbfFRSb#
#BVVbRffCVbBCMbBVbVRVbfRRVFCbfCFbfMRMfMBRbbBHBVHfVCbVCbRVfSHCbHbHRFMfBVMfbRRfSHbHCHMCRBbBHVbFFBHRBF#
#HHRFHVVSfBFbVHCRFSHVVfRBCCffSBCCCSFbHVVRHMVbFBHSSHBMHHffRbMHRFSBbFfVbbSFCHBfHSFHSFFHBCHbFFMBRFbBfS#
#BSBbbHBVHCCFHHSSMRSBFBSVSSMHMRHVSFFHHSBVHHRVbFHBBbRfSMCbHVHSbBfFfCbSSBfbRMbMBHBCHMfCRSMCfVbBVbVCVH#
#CMSRMCVfFBHHbfBHHbCfCbHBBbRHFMFVBCVMbFFSBVCCHRBMSMSCVHHCfMCSSRHRbMSHfVBbRSfRHfRFRBBRVBBCRFBFHbfCFR#
#RHHRBBRSVHBfBMbSVSBBHCHFSFFHbbRRMCFMCbCMfFbBVBHMBFBVfBRffFFCbVCRHbfHSbBfHSfVCBFMHSRRBHMRRRMbfRMFVV#
#CfVBCSRfCRRFfVCCBVBfCRbHBCFRVVHRMVCMVHCFRfMBVFBRSCFRbFFSSCffbffSCfSfCRVfHfFVFMMfHRFbbHFRRRMBHSFHMR#
#VVRVVbbbMCHHbBSHMSBbCCfBFRbVFFSMVfbHFMbbSMVCffbRbVBSCSCRVHVCRBFHBMVBBFFFFfBMMVCCbbSFbSRRFMSCffCBFH#
#bRMMFFVfbFbVMVbCBfBHCBBFfVFSbMFHbFMfSSVRSbHMBHCMfRBHVCMfbFBVBRCRRHHMfBFBHbHRRSFFFfRVbRbfHMFMVHCbHM#
#bbHMMSbCMVbHCfSMbbHHSSMfBbVMBBFBfHHMCRSVBVRHCVFBMfCffbCfRMSCSBHbCHfFRCHCHbFFRSCHHfRFbFRRFBFCVCHCfR#
#BHfVSFVHBMSBHRFRFRSVbRFBHfCMRMVfMfVMFCCRSbFBSfMVHMSRSfHMCRHCbCFfVRHMRBVbCVRfbRFRHHHffbfbBbBfCVBSCB#
#fbbCCbHFRHHSRBbSBBSHSCbBRfFFbbSBCbVHRMbRSFVRfMMFSbBMFRSRbHFVCCHbVRRCFfVHBSFFVSMFBVFfRbFMFCbVfFVSRM#
#CfHRFFSCMFFCMfFfRbBBFHHbfCFbSFHfCBHbCRVSSfVfMffSVfSFbMCfFCMBHfRVHCfBBSfFRVBMFSCFHCSCSbRfRVMbSCHRHM#
#HMbRRbHfCBRBVCMFHCSVHVSMBfRSBfSVfSMCVFCRCVCBfCBCCfbCFBCVRfVCbbfSBBSfBRRVfRRBMHHCCRHbBfFHBbBBSffRMf#
#CBBBSVMMBSbbbbRMFVSSbFCSBCSCRHSFSbRHFBSFCMHBCCFMFRCfVHCHFHfSCRBfVCMbSFRMFMHVBBBHHffVBSMbbRBHFfVBBf#
#RHCfVMMfSMBRfbHbFSSSbVRBHFVBVMbSHCHHFFVfFfbMHCVFbVSfffSFMMMFbBFSBMCMCFCHbMFSfRFbHVMVCBRfMHVSbMHBSf#
#HCCFHMCRFbCMVFRBBBBFbRVMFCRMCBMbRfCCBbRfVHRbSCBbMHFRbMHBHMfFHfVbRHVFRBHRBBCVbbRFRSVfSMVCCSSFSFSSbF#
#MFCSfBFRbFBRBCCfVbSHMHCHBMfBfFHSBCMRMRbRMVfBHfMFFFfbRfCVCRfBMffBbFHVSVVMVVCBMVFHbfFSFBFRHVMVBbMVSR#
#HBCHHfMSHVSfCSBMBRSfFCSCFBMfCRHfBMVbFFBMFfCfBMVCCBCFBBMbVBbfCFRMbCFbbMMCSVHFMbfbVBFCVRfRVRFVbHFCSf#
#bBbRSMSHCVBSBCbMSbVBRVMVRbCHRVBBbBffSbSCMffBSMHbBbbBRHRfFMHVbMfHbMRRFBBbHRRHbMRFHfVRHfCCSbFHSMMSfM#
#SFRbFBfHMFbHSbFbVVbCbfbVCHVRHSbHSRSMSSBMRBHMSBfVFBFfHBHBFfbVBbbVVFfCBBCHFbfRHHSRbVfVbSfSBCHMFVRCbM#
#bBMBMVMfVbMSMVHRFfCRSBbBHbBVMMHfVFBbFBHSRffCfSbRHBHfVHMVCCHVBbMBVFBCMRbFMFSBMMfCVRVHbfVBSBHSFbVBSF#
#FFbMFBVBCCfFCfRVbSMVffbMSHFMSSbMCbfHCBMFHMVfVCBSMfFMCfMBVVHSVFVFMSbHMCRFHBRSFBMRbRSHCHBRffBVBfRHSb#
#fCBHHRSRSSFffRVbHFBbHSbfCVSVbMBHHVbRVbCbVbRfVVMHRMSHFVBSfHVCfBfCBVSCMHbSHMfSCfSVfFSfBMVCVfCCRBBFRF#
#RfBbbfbVBHfSFVSSBCfRVbVbfCSVCRHRMbCVMSHMVCHfCVfHHSCHRbHFbHCBRBRMSbfRSBfHCbfVRbbRfMSFbSRffHMBMfbSSH#
#CVRRSBfHHfRbCVSBRfSCHbSFSRCBRCBSFRHbFfbMCFVBVRBFFFBMfHVCfFRMMbRSVMbbfMBFCFFRSRVbCCHbbBfMBSSRfBBSbf#
#VRCfHFVSHfCBfFRbfbfSBVBSRSRSBFFRFSCVRHfRfffFRVFBMBCVFSbbRVVHHBCSFBBBMRHMMVHSHRHSMRRbMFHSfVHMSVHfMF#
#VbCRfCHBVBfMCCHbBCfbVRCBHRbVffHSSHfHCRbFfVbRVVBHCVMBHRFVCMMVRMbSRfbHRVBRMCSHbFHfCbBbSVBBfCBfMHHHfV#
#SHfVVMCBBffFRbRSVfBBMFFMHMRCMRCMSVHfbVBCHbMbfHVCVCMbBHSBMfRRBMFHSFbFfHbCBHCbVBRVBFfBfBRBfHSbSCMFBV#
#CRCHRCBHBfFVSbHfbCSBfFHFBHHBMSfSHVfSfBRfRSfMVFVCMfCHVVVVFHBVBbVFBBVbSMSMHFSCfMFbSBMHHRbVSSVRSRMbFH#
#VHbRBSFSMRfFbMFSMHBFMCRbVRSbBFCMBRBMVSSRVVBfVBBfVSVVffHSbVBFCSSRCRffSHMHMMRVMHBHFCSMVVfCVCMVMRRbRR#
#RbFMMbCfFVSHRHVbHSfbHfRbMVfbHCbRVVHfMfHfVFbMfBHbSfFCFBFbBMFMHVVBbRSbSRVbbHRffVRFVfHfbMbfMCRbVVVbHF#
####################################################################################################
