####################################################################################################
#CRVSSFMBSSHSHRBCfffCbSHSbbHRBCHBfbCHbbbRCfHVCfCFffBHfFSMbRHFBVRbSSfRHSSMffHFMfFVBbRCFVSVRVSVbMFCMV#
#RFVCVFbSRMRMFbCVRHRSHCHBHSMVbfVbVRfVFSCBFMfHSMCBSMHRBbbMMSSbfRFCbMVFRCFbSRbFBHHbCCbHVMbCfMBBMVfHHS#
#VbFMSHfCFHVVVCBBCHHSSVMRFffbCRVCBFCHfVFHMfBSVBSCCRFMbBHBSHRBRHbfVRVHCCRMffCSfffHCCRHHSCRffCfBHRSSF#
#MbCVRCRVfBMfMCfMbffbFbHVBCRBVVRMfbSHfFCbBbRVSFMfSfFMSBRBfCfHCVRbVfVfBbMVVMHfVffbFCHfHSBMMBBBMHbfBF#
#SFFSfMbVHCbbVbBMfCCFFfMSRfMfMMSSHRBFFBCfMBBMMfMHCVRHVbVbRVfRMbRbVRMBCRFCbBVVCSHRVVCCHVFRFHMbHBFSRb#
#bVffRVCHCVfHFffbbHRCHCfMVHMfBbbbCfRVVBHVVHSHfbBHVBVHfSVMSfFFfMSfVfCbSSMfMVHBCMbfbBRfSfMMSRffCVBfFR#
#VSBVfCMSBFbCBCRSHVFfBHVHMHMFSFFFVRbfHHSHFMCRfCCfVVHVMfVCMSfCMFMfHSVHRSSRbbbfSMCMVbffBfHfCbHHFBCMRf#
#HSfRMffSBVfFfVSFMCFCMSSSBfHfFRVfCbHbbFVBSCBSCCHBMfMBbCCMCBfCRMfbbMMVCMBVMHRHbbVffMffFVFVBVbbHbbHBC#
#HfRCFMMFCbCSVHFCfBfCbffFVHHbCHHFBfSVBfRHfVSfbfRMbBBHBfMCMFSbBfRSfVFSFVBRbVfMVHHSVSbHFHRbfbHSSfHFBb#
#bFfFVSVVfRSMCSSbRHbRMBbRRBCCHVFCCfMfMfSbBBBfFHHbRHBRBHVHbVbVHfFHHbVbfbRFVFHHFfHffBRSbCBSVVFBSSMbFC#
#HVRBMSBRBHBFVFMHbVfRfMHSVFHffSRCVbCCMRSFMfBfMMCFfBMCBVVSBbMBRHSfMCfFbBMBMCBCfbCBVHBfSFCFSfVRfCSbFC#
#MCSMFMFHBfFHMHbVMHBHSSHFMbHFHRBSBFCMfMSVfRFFMMHMBRCbHSHFVBBRBVVCfCFFCSCbCSfSCfbbfMCVHBCRSMCCfFMbCC#
#FCSfVRFMSFFVRbVbMbbFbMMBFfSVFCVCBBMFRSBSFfFMVMBbVRVbbHBFCBSbBbbfSVBfBFMffHCBRfSBHfHHfBVHCffFSfFfVV#
#bHSfFfMHBCRCCMMfCfbCSHBCHHSFbVfFCCCCbbbRbBCCFBRHBRfVSCHfCFMRfSVRSCFHVRHHCMVHVfFRRHSHbMBVSSSVSHCBRF#
#BCVVMSMFHRFBbHRbBHfbRCMRSMHRHCFbRMMFBCffVSHRSfBHSSMVfMSHbBVBVbSMMbHCVMSSVSbSBCfbbVMRMfBfVHBRHRfBHC#
#RFBMSMHbMSHCFfCBFHbCCCfHbVRSbRCfHHHFfVHBVHVBHRFCVVVfFHVHCBFBHVffSVRHVMRfVbVVCSBbMbBBMSCRSFFfVBbFbR#
#HRBVfVSRRbVbVBVVRMfFMFfMSfRMHBBfFFFHRBSMRHMBBHbfFVFBCHVFMCbCFHCfFVRRffRFSRVCMCfMbMVVFRBVSVfbVHbVVM#
#HRbHSbMbHHVCbbfBMbBRRFfVHbFMbbMSRHVRHBBMSBBSRMHSffVfMCVCVVRbRBfVRFSbMMMCbBBCFFBHbBbSRffCfbbbfSHfCC#
#MVVfbRRRRBRBRbVHRSFFBfMRMfSHRMMRHBMCCRFbHCFHfSVFfBVfSHRFMMSSMBBVMHbSBFRbSMbbBBBMRVRVbVHMFCHSfBbfCS#
#VFHMCbHfHfMSRbSCfbRFHbFbHfVVFFVSFbbfRMSBVCVBBFMRBRbSSSbHBRSffCRVSbfbRSCVbBVSCHfCBbCfMBBBRHMSVMHMMR#
#VbbbMfVCCSMHBffMFVHCRHVVMBRBRSBfbCMVVMMRFbBBFbHfffVfSCRVMBFRCCfRFRRfHRBRRRHSFFFHfbHBMbBRSCfHMVFFMb#
#MCFVBbVVCFRfCfFVVMfSfBBVVbRHCCBHFVRRRFBMSBHVCRHSFfFVbfRFHHfVFVRMfCHHHVRVHSHbHHHFHMFfVHfRCHfHFSFMCB#
#RVVRHFCCRSbHbVbbCCHCBfffMBCRVRBCbVVBVMVCCHSVMfRMfCCFHVSFFSbbfMVbCSFSFVFHbfSVMRfbbSbCSSRfMBRCRfCMbC#
#MRSbSVRCCFFRHHVFFBbFRRSSHBCCHVfSFMFMBbbCRCBHSfVRBVFbMCMFFCfMCMCFfVbVMBVBRFHSRSbMRVFBMSRCbfbMFHMRRM#
#SRfCRVRfMBVMCVVCSfBHRfSVfbHHfHFMfSRbBbCBFCCVbRFRHRCfRBFfHVCRVfRRSFSCCCCBSMVfSSFSMRSMRRBbbHbHBCbFfB#
#VBCFCHCCSRHFbSRVHFbFRfbMbRSfbFRbMRBbfRRCMCBbSBbHVfBSRbfHbBHVVVVHVfCHHHCCFfCRfBMMVSCSBMbCbSHFMBCFHM#
#bVCCSbCVfFMFSHSRCbHVbVBCRbBHBMffFbbbMSBbCffSSbbVCMBVSHBbfbBBCHCCCbfFfSbSRVSSfCVbRMbFCbfRCMVHCVBVVH#
#VMRVHRMFRFSVbBFRVVHbFSbMMMRbfHHSRVbVCHfCSffVRFbHFVCVFVRRSfbbBSVbHHBRSSBVCbfSfCVfFbVHCVCCFVRBVbbHHS#
#fbBHSCbFBVMVHHFRbbbHCBfCbVfVCbFRffSfCbSFbVMRBVCVSSHfVVVRfSBBBCfBVCHbBSbfBRHbSCFBSMVVHBCfMBFBHbBFbb#
#HRFFVBHCVFBCbRVBRVCVRRVFbRRbRSMMCSVSRVFbSHfFfBFRHbHBRffSBFRMfBMMbSRfHbCbRRbFCbFbCFfMbBHHCVFCfBRVBR#
#CFfVVHHFSHHVbfSFMCHFCVFBfCVCVVFCVbFBfBSFBFBBFHfBCSFBBHMRCbBRCCVSRHHRfHVbCHbFFCbSbbfFbSCSCRFCCSHRFB#
#fbCVFBSHMSfbBCMfHRSFRRRFBVfbbBFCFVRBMCFSCSRCfbBRBMFCbFfRFBbFFfSCSfVbSfCRMSRMCbCRVFMHHSBCMVMRfRCVFS#
#CHRMfbFVHMBHFRCMHRbRVCSBRfMBfVCCfCVFVRbFMVHCbHMCMRFfCSfSVBVMBMRSHCfFfRBCHSRFVRSVVVSfbfRbMMRRBSVSbB#
#bFFfVSSCHCMVHfFbSCVRMbRFbHCRHCFMfMbBBFBRbfVVfbfMFfMbMfbCRbbMVMfVfVfBfRbRbVMFfRBMVMCfMVfHFFfVCfHFRS#
#MSCSHbBbCHbHHbVbHBVSRSFBFCbVMfVVBCBVFSBHVMBBHFFMbbfRbRRbbMSbMSVHMFbfFSBFSHBFFfHBMVCbBMBBHfMSFfVCCC#
#HHbRMCFBVFFSRVSMSfbCfBRSfBVbSVFFHbRBSFFCBCfCCVbbRCVRfbRBSHVHBCVFVBHSBfHBVFbCRRbfSRMBVMbbFFSHfMCfbf#
#bVbRSSfbRFbRVBHVBCMMfRMFfSBfRHfHVSbbVVCbCFFHHBSRFVMHMCBSbfHMMFfbSFfbCBfBBRbCbRHVbfSHRFRFBHSbVVRbSb#
#FCVHRRMFfBVbbMBFbRCCbBHRSMBbMVMFfBbBMBBMRfCFMfHSRCHbbSCCbFSCHRCSCBVMFMMHRBbVbRBBBbHCVRSCMMRMbFCfMR#
#fHRVFfCMRHRbFHBSfSVBSbSBFCCHbRRMCRSRHMRVMMBVVbRbRCBCFVHRCbRVSbBSbSRMMBMRVbVBBSFFbFbBRHVfCVSbSVVMCB#
#FBfFVFBbfRfSMSSHCCRBMVMSHbHRHfCSCfSVMbSFfVHCMCVVRBfBbbCBfFFfCMHbMfMVBVFSMFMCSVFBVVMfMFbCVfHHfFFSSR#
#FfCSHBBffHRFHSRVFbHBfVMBVfSSBCRCRFfBfMVMRFfVMMfCfMbHbbbfMHHFbbMFMBfFFCVVVRCRbBVVHBMRMbRVCMVfRRBVfV#
#BHHMVbHCBSHMSHMfHBBSfVbRSCFMRMBSFMSSVBBCbFfBHMCHRbfCSVVHbVFHCSHVbFFCMMBHbCbfBSbMFHRMbbFRbbVMMCFRRH#
#VMVRHfVCbfBMMHMFHMbbHfBMCBHfBCbBHVSRVCRMfSSCffFMRFffBFbffMCHRfSbFSVSMCMVVfVVCRCRSVbCbbSHBVHFSMMHbB#
#SCCCbVRHHHBVHRBSRHVRCVHBfMFfRHFMHHFfHbVbfSBCFCHSSCBSHbBSMMfFMMVbBMHMVRfFbVBSRbBMfBfHHfMSHVRbSCRMSf#
#RfVHFHbVHVVSVMVSVMCHMSfHCVFbVCHBHSSMRHSMRfSSFVHFBBbFMSfBRHFbMRRSMVRVSRfHFfHVMFHbBFRMHCMCCVFRRRHFMS#
#HFFbRRCbRHMBbCHSbBfSfVBSVVMMRSRbBMVSCVSBffbfFCbRBbfSVSbbFSMfHRMBVBVRFMSfRSbbCbRBSVCCCVSSBbfRSCRHFR#
#BfBRbbMCSHHHFVBfHRffSRMSSfFRfCbCMFHbbSfMVFSFVFRMVHHVfFfFSfCFVbMBFbVSHVFCMVfBSFSSFCVFfMVMRVMSRMVMCb#
#BbVVFHSRRFMFBBBfFMVbbFbVMSVSRMBHBRbSMbHbbMRFVfCCFBMMSRHRbRVfCBfMRMVSBHVbSBSHffSfVfMCSSbfBFRFRRbSFH#
#BCFVCfRSBMffBFMFBCbVBBBRVBSbRVRFHMRMCMRCFVSMCbCHVBVCSbFMRCMHbRFBCCMSfRBBCHFRSRHMSCMHCBMMFFMFSbVCVR#
#CSHBFbVbCMVRVRbHSbSHFFCHVCHBbMCMfVBCMFCRCfVMBbMSRVbFBMSMCVVFRBBbbMVCCCMfBBVRbbHbCfVFfVbCbfCCBSRVbV#
#HBfbbbVFbRbVRBCbBCBHSFMVRCVbSMRMFRCRSfbMHCSCSSVbffCFBFVRHSBRBBSSHCFRSCSMHSfFRbVMMVfFCVCSbFVbFbVCCB#
#MSbMHbVbRVbMfVBMRRBFffSFMfFfbffHMFCVBbRMbRfFBVRHFFFfbHSBMBFMbVVbSMMBSMRFBBRBBSbfMVbCHMVBffBfFMRMbF#
#FbSMbRVVRRSVSCVfbbCfVbBbfbHfFCfSbBRVHBRVSfFHRRBSMFMMMRfHHRCHbCBMBSRFSHBCSHHVFBFRMHRFFBMBHfVMVVHBff#
#VMMBSHSMHbBMFFMMSFbbbCHMFVVFVRRCHVFFVMbCMfbVfbVSSMBHfMSVHbFMSSCHVHRfBFRbFMCfSHCBMRMSHVfVFFBVRBbRRS#
#RFRSSBbSfMbMfCHMCRCSHfFFfBVCBSMBSSbCCRCBVSFFbbHbSfBbMSfbSHMHfFHCfCCfHMfBSHRSMVFCMSSCBVCSCHbFBHBMMB#
#HHMSRHSFCSSCVSSbBCfFHRBHRCBRHBFBFCBBVHRbVSBSbbfSBHRRSMVfSCfHBMVFbfbSSRHSFVSHHVCVBHHFSCbHbHbfMFCMCR#
#fMMMVVHCSBFSFCVRbCBfVVfRfVBHbFMfFVFVSfVVSMBfbMbFFFbHFfBBFfCfBBCBBRFVSCMMSRFHCffSSMMVCRVfMSSCfbMRBM#
#SVBMRMFVHCVfCBSbHfRBSCCVbMCbFbfBfMRBBSbBSFBSVMBVFFVbSVHRMVHRbfCbbMSMCbBVBCfCbRVCFffBBHMfVFMbBFSfbR#
#bVMMMMHRRSCMMFbRSVRMFfVFVbfVSRSMbbCBHMFVHCHMVFCHfRbfFRbCVHBbMHMRRBfFCbSFSMFFCFVMbbMCBMMRBFFbFfHSMf#
#SSBHVVCSbMHBBSRCBfHSBRCVHRBFFRMfVRHfSMVbRbSbCSMbFHSffMSBVMSbSBbVfffHMRHMHHFSRBSVFRBVBHRMFSHBBbMBBS#
#MHHHVBfMFSVCbBfSCMVBHVFFCHfRVRbMSbFMfBCVBCfBBbfSSBCbBCFRCCMSFMBbVbHCMFbRVVHVBHffBCHVCRRSVBCVRMfVRS#
#HCSfCSCCFCSfBHVVFbVBSBHbBHBMHVSbRRBFHbRbMbVbFMFCfFbFbCFBHCRBSHBHbfRSbMSSHbRMSCfVBfBBCRCbRBHMHbMVHF#
#bCFbMVbHHFfBBBVHMBMRfVHVVfFCVFFMBCMCCSMFFMBMfRVCHFMbfbHbSRSfMSVbMSfVCMMfVFSVFCfRfHHCfFMMfCBSRfSSRV#
#BVSFMVRCHBffbCfHMfFRMCCSHMBbSCCfbbRRFHfMHBCBRFRHHCBCRVfVCVbCCVbVRfbSBSHFCHSFHRbHVCSHfRVbMfCMSCBBff#
#ffRBFfVbSCFfMMMCHFfbbSBHFVbfFfFSBHCMHHSMSHRMVBCMpVCFBVRVbBfCFbVBHBSfFbVVMRBfCRBMSMCBSSMMBFbFFVHSBV#
#SbCfCMRHBRSRCVHVbSVHCFHCbHFbfFSSCMfbBVffbBBVFCfVVfbRFMSbBRfVSbBMfRSbVCHRMHbRVVfCFRfVRVCMbVRMHHVbMb#
#CCBbfVbBbRRBSBRFbFCfHSbHFVCRFfbMSMfBSCCHVSRHCRBHRbfRRBHMFbSMBfHbFRCCFCHRHRVSVCRSVRfMfVMMbFBHffCFMb#
#HRBFSbbFVSbRBMCMBCBVSSSBFbHHMCMBVMbSffMCBCbMfBMVBHCBFRHfFSCSRFfCRMCbFCBbMCFbSMBFSMbfbMMMMHVbSVRFHM#
#RCHRMCCCMRHbBVRHBMbBVbBRHFRfVHMbCBSBSSbFFRHFbVbMbSCCHRRFBHbHFFBHbMFBSBHbFCCRMCRSRVRBVfVCfBCBRMVCFM#
#fVfRCHFbMffHRRCBfSHBVCCfRBVFbSfFbRVSfMMbHSCFRSFRRVHRffbSMVMBSbbRbVVRHfFCfBbCHSMHfbRBfRMHbRSCSRFSMM#
#MBVHVRBSFfFSbfVMbFfVRSHMBHBbbBFBbMBCMBbMFbCVBSMRRCVCFVBSSBCbfVBBfHCCBBfRfBVHRMHBFVSMSMMHHSHbMBRRfS#
#CSbSRCMCMbFVBMHfSMbFBBfBfVbBFBHHBCSHVBfMMfRRVBCBRBVFRHSFRRVSHCFRCfffRMVFBBSVFVBCfRFFFFSbVHFBRHMRFS#
#BCbbMHMSSHFSFMSRRBHMRVMHSHMbMVVfFSFVHSFfCRBHRHCCCVfbCCHVSbfVFRFRMRFFVfSBRHMCCSMHRRRfRHSVFBFMCCFbHV#
#FCbCVFVMHffMVbHCFSHVRFHHHSbVVSRBVRbVHFCfCSbMVfMbbbHSHFbbVBBRFfVFVVfRBRBCHRbHMfHbSHBRHRHBRBRVCBHRRB#
#bHFRFVVMSMfSRFCfBCRbSMMbMfMFHRRfRMbCRFbFVbBRbRFFfbBffCBMMFMMbfSRSVfSMMHBRMbFSVbHVFBFFFVHRRHFCBVFFM#
#BFVbHHBFBCMCbCCSHHfSFMFCSFMHbSRfbMBBMCHVHbRFbHbMSMVHHfVVRbHBbMCBbfMMFSHCCHVRSMbCFVCfBfCCCSVfbHCVbR#
#fbRHFMbCbBSbFSFMfCSMbbSSRSbSFffbbFBfbCbBMfRRBHfCfHbfMMHCCfSHFfFRBVbSHfbbCCfRSfSVVCVVCCCMMfCSHBRbFf#
#VVVRSMfMVbHHBbCfHMHfSbRMCfFRfMBbBFFCSbfHffHVbMCBSCSbFBfHBSRCfVBSbVHHCHMfSBFMHHVVSbHCVSHCCMMCMfVRRB#
#VRBFMFSMMVbBBbfSMFfFBHRRHFHfVfSHVSSRRbbHMFBbBFVRRSVSFbMHFMMRCSSSHRHFBbfVfMFFbMFHBHRfRRBbVRCHfVSSfB#
#SHSbCCFbbCbFBBMFFMSVbHMCSCVRRbBMVCMfHBFSBMRMSSfSSVBHHBbVfHbBBVbHFbbHHFMHMRRVBRMVCMBRRHVVCVMBHCCfVf#
#BRMHRbBfFHFBSFMMBMBBCRVVHbfRHHfSFCbfbbbBMBFCBBCBbHRfMffFRbbFSRfbHFVbFbCMVHRbBHMVRMCCRHSMHfSCMbHBFH#
#fSfHMbMBHFMFCSRRbfHBSSBVHfbFSCSCHSSSBSRMRFMbSSbHfFRSfFVSRbFRHHBSVSFCFbMMfRHCHCfVRBbHVHFHRbfBHffHBR#
#fbVVFSfRCVbMCMbFHCSBMCHMCVbVfFCBMFHfSMRVfHMHHMHMSCFHFFHbFbRRFMffRMBVMSCSMBFFbBSCbbMFMSBHHRbbBVCCfS#
#fBFfSbfFRbVVFSCCbMVBfHHMbBbFSCBHfMMVRHFBfVRHBSRbMRbHCfFHVCVbFbHfVFbSCHfMSCSRfHCfRFHMRMFBbRFFBFMSBR#
#MRCfHbRCVfbCVVSHCCMCFSRVfMCVfFBbBRbMSVHHRfSCSbRMFHVCHFFSHHMVbBHSRVSFRRbBCFRSBHbfffHHVSMMRVfbBbMfff#
#VCBHMMBbHHCHSBCffCfFSfFfHHHSFVVBVCbVRCbbCHMHCSSfMbBfVMSHMCfBCHbCbFHHBMSbCFFBbRFCFMfCVCbHbbFMRMHCCR#
#RHbCBFRbMBBFbFCSbVBfSfBRRbFMBfVMFCbMRCHSBfSRHRMMHMFCBbCCffBVRRMbVfSbHSSffffVCCFVMfSSfHbVMHRfSVfVCM#
#BBCCRfVHRHbSSFVMHMRMHSHFVVbSCHVCfHHBMSSVVfCfBHCHCRBFSVBRCbbFBSHRMFSCVMHFCBHMFRMRRfSMHBCFHSRBbbSCSb#
#BMBCMMbHfCFBRHVSbVbBSSVBCCCfFMfRMBMSFMVHCVCHHRMVSCBFMVfSbFVVFFCBBbFfFVbfbbVfHfSSVBfHRHFVHMfMfCBSbf#
#HBFSHMHHbFfFSVBRbVbVVbVSfFfFRMVVfRFfBbVBVfVfSVCHVRHRbffCVfMSVFHSCbRfCCbSHVFBbVBfMVfSbRVbRMMMBFbBRH#
#HRfBHRBRfSbffHRBMBCbMHSRVRMRHBFRVFBfSSVVMHFVHSBSBMbbCFVFfHCSSbbCbSVRVMbbFFSMBffRfSVRFfSVCFffFCbRFb#
#RSHCHSMVRVFHRMRHRCRCSfMSFFCSHSFbHFFFBfbVbCMSBMHMbBbMHBVCBMSRMCVCBfMSCMVHbVVHHMbCRFBBRCFbSRVFVHRfBM#
#fFFRBVSBfFVfMCbRVCFRRBbSfHCVBRCBHfFfRVRRRMVSSBBbHHVHSCVBCbHSfFHCHbVCFbCSHVMMBMRMBfFRMFFfbbRFBbFbRR#
#HRCffBCFCRbCbHbbFBBSFCBbBfMFCHVRbCbCFFHffRMffSCFSBBMMBHCSFbBfSVbCBSBFHSFSCSBHBCMCfSHBMFBMVMCVRSFBS#
#MHMfCFBMfMfFbCbCBFMBHSSMMFVSMVHMbBCfHCFCfRSVbVMCffVBBFMfMMbRfRHCBFBMfRHRbRBfHVFVRVBMHSVRfbRSbBCFbV#
#bHBBMRbFMSbFVRCHCFMVRfRCHfSMMCBHMMMRCFBBCBfSfbfbbBFHfHSfFBFBVRSfRMbBMMBRRMffSfSCfHbCRBVVBbRHVSMFfV#
#MbbfHSHbMfRCCBfbfRHSfSRVRBFfRBMSbfBRRCMBHfHSbHbfCSRSMFCRfbSMbSHVHSffSFRFSSSbMCFHHVRFFfCMMRBfFbfMHS#
#SFCfCBBHFRRVFbHRHFfVMFHFfMCFFHCRFMfFbRbSMHBHfHVfFVFCRCfHbMFSSFHCffSBCbSCbBVRRMMRfHCFBSCHSBMFHMFRbC#
####################################################################################################
