####################################################################################################
#fMSBBFSHCHSMBCMFHMHRfFbbCBCSBSbSbBBBbRRRCCRBfbHHBbHfRHCfSHFMHCfbFCRMbHFFSFMFFFfSRSSRHHSMMfRMSfHbSR#
#HfBFHMbHFbBCFfBBfFMfHSRbSHFBfbSCMBCHFSfMCCbffHBFBbbBMCfCSHfbFBRSFRMFFCMMFbSHCSRCMfMfbSMHMSbSbRbSRR#
#FBbRBBfFFbBCFSfCfMMHSBCCMSSBCBCSRfFBRMHbCRfMHffRbfSBbHSHBbMFbHFMFCSSMBRRFMfRCBFCfFCRBFCbSRFbRSfbBH#
#RMMCRFffMMFbSCHBBBHCRFHCCCRRfCFfbfSRFRBFffMMMSBBFHRfHbbBCHSFFFHHHBCHCMCMfHCBffSSbRHbfBMbbHfMRSHbRM#
#bbFCRfFFMSHRCBMHRBHRfbfbRRBbfMMSMfSMSBMBFbffCSMHFCHCSHfHFSffSBbBRCfbCFCMSbbRMMfSSSSbMFCRfCBbBHbbHF#
#bBFBCBFRfMSHfbSSCMRHBCRHCMCffMHHMbHCBBCSMSbFMBCHCFSHRMMMMFBBHHSBBCCfRHMSRHSRSCfFFbBHFfRfRCFbRbCRMB#
#FBRffbRCSRMSRBRHRCFfHHBMfbCfBfSbFHbCCfMSRHfCCSBBHSfHMCHMSfCbFHHCRFFbffHSHHFHfMCBSCMCCMSfCRBfFRfMCF#
#CfHRCHCHMSBHRFFRHBfHFHFMfbfSSbFMbSHMCFBHBbRBFRCBfBSFFSfbFSSBCMFHfHfBfHCMSFfHHBRBSfbBCbMHffHBSbbbBH#
#MfCCSbSBFRRbBfHFCSBbBCFSHbHBRRSSFSBFCBRbSbCffFbbFbCbMbMfFMFbCHbHBHFHSSMBHFSFbFHMCRfRFbFFbHFBBBHSfC#
#BCSSCFSMSMFFHMMSCBFSBbCfMbSbHCfBHRSBCSSfHFSSHCCfSMSRHSHMBMfbRFbBBBMbbbHSMSMSbRCSbFfHSFCfMfCbCMBbbF#
#fbSCfFMfRFCFFFSSbBSbFMBMCHBSBBCCSMfMfHCHRFCCCHMSHSRSBBHbCRFSbMHSfHFbRfCRRMSMRfBffSSRSMHSRBRRbMRCfH#
#HSMMFHbBFBHffCbCSfSHCMHRRbfHHRHCFBfbSHMFCCffRbMCBbRfBbfFHSfffFSSfBHFCffMRHfMSbbCRCFfbCBHfRFbMMFFMf#
#SBSfHfMSMCMbMRRfFbCHCSbbBBFbMRCbFCFRSHbfRFCCFHfSSRBFFCBfbfHBBBSBMMbHFRMBCMCbfFbFbCBbfBbbSFCfMMRbMS#
#fFBbFSfFBbCMRMSSBRBRfRRBFFbBHbbCMCMCbFMCbBRFMSSRfHbHMfffBffMfFFFBCMBCFHSRBbFbCMSFBSRCFBbbMCbCbBHHH#
#CFRRFSMHSFbFFFFHSCMSHCSfFFFfSSFFBMHHSbMCfBbCBBfMFMBbHSCCBMCRbbbFbRHFFCbfbFBbBFRCMSCSHFHBMHMFbRRbRR#
#SBbFMFHFHFbMHSSBCMMbHSFbbSbfbSCBBHCHbCHBFRfSRbHbMffRFHHFCSFBCFbRHSHCFffRHHCBBRFCRFHFCHMHHBHRMMSCSf#
#CMHfRbCRbRHRfSfMHfHbMSSSSFfbFBSHbBBfbBSSRBCFbRbHfbbCCbFSRHHFRMBbBbffbSfSFMMHfBCbBBFfHHHSMFSHCMHCCR#
#HBCbSRCMMFSfFRbSFRBRBFHbFRMBCSbffFHRCfSBfSHBFSMFMHSfCBRfFHCRMfHFMFFRfBMCHMHCHfFbRBfHfbSRBCFMCbMFRR#
#MSRBRFCbHFHSBRfHHHfCSMBFMbbSRRFSFBFRSMBBfHbCRMHRCRFfCBRFRCfHBCMSFRRBRFbFBFFHMRFFFbFFBCRbCbRHfHbHSH#
#SMSSFBHRMRHRFCfbBSbMSCBSBBHBBMbMFbBSSHfBRBRMCFMCHRFSMFMbBHBbHfCRfRCbRCFFfbfHHbBSMbBbFFSMSCbRfCSFRR#
#MbbMRMFSMMSHRBBbRRCMSHMSCRfMRSBHHBHRCbHBFBBMFCBFRRCMMSCBRRFbFSHRbRMRBRCRMBRFMHfCfCCCMHfFMRfMBRfBbF#
#HCFBfMCBHfSbSMCFMBMSbCCBRbCRMBbMSfBCMSbHbbMMFCSHBCRFSBSFbCRCbSMfSFRHFRRbBBBHbCfMCbCCHRCFHSFCCBMfSC#
#RFHCCCbfSFBSSbbRSFSFHHBRCRSbFMfCCSbFBRSBfSbSSFbBHSMCCSfbMSHBMFSHSSRMMFbBbSRBMRFMffBbfHBSBCbFFFSfHH#
#CBFbBCbbMRCSfHBBHbbfRRFSFRbFBHCHfHMBMBRHbbbCBRbSFRFFBCCfbFCHHFSCSBBBHRSRSSbSHfRHfCBfSRCFMSfHHbbHRS#
#CfMRfRFCbFCHFFRHbCHfSbHBCHBFBSfHSMFRbRHfFBMRCCHHMRRRbSRFMSCCRfBfFFBfbSRbCMSHCMCCCBRCBfSSRCCHSCBbHf#
#HfBHFSRHHFCBBHHFfMSbRFCFffffbbBHSMBbMMMRMCHSMBHbSRMHFCSCBSRRFCHRBbBRHSBbFSSCbHfRfMHBHRbFCRHfSHHRBM#
#fBfSHCSfbCCFFBHbFBBbBSRCHFHbBHBMFCMbBBBBbCFFfFfbBHCSHbBffRHSFbRMbCCRRCBCMFfMBbHCMSCSfRfRRbRHHBRBSb#
#RSHbHbFBSHMBCbSRBHHHMBBBHBRRCHHBSbCRSHFRfBRbbSbBFRSRSCFBFRCFFSCRFRCfHbCCHCFRRMHMfHSCBRBHFMHCbfBCCH#
#MBCFBbMbHCBBRCCSHMHHRHSFbMHfbfCSCCCRBfbbSBbMCbbSHSHHSCHbRSRCSHfRbFBBbSBHMRSSCFHRbbCbSCMSHHRfBfBbFH#
#bHfHfFHMFMfbbHbFHSBBfFSBfFSfHRBFBBFSCHSMFbMbCbSCCHfHHCCRBMMCFFbCRMSHHFBRSSSMMHSHCHbHRbFFffHbBHHCRf#
#fSFSBFfHBHBMMCSMBRCMRBCCbCfffFfSRBbRRFbSHbbBHfMfMHBBRFfbRRHSfbRbFBSfSRSMSbfSRCSfSSHBSMbFRFMCbBSMMb#
#CfRBbHHCMfHRHHRMCMRfRHFbFBFFCSFRHBHfBBfbCbbSHHbbSFFbMBMFFRRbSRbRfHRCMCBBFRMFMMMHbfRbRffBMRRFSfRfMf#
#HRbbRRRfSFHffRMBFfHSbCCfHFBBHBHCFBBBBbSSfFCfMSRHBSbfRHFFSfRRSCMfbbRBHbCfHMFfSbbCfSRMbSbRbBMBHHbRSf#
#SRSBSbFMHSbSBSRCbCFCFBHRbBSFCMMHCCfMCbMbRHSRbFSBMRHFRFfHbBbCHRBBfMSBBSMBSfRbRfSbCSMbSFCRSFRbCCHRHf#
#FfRFHMfHRbHMFFFCfRBBMBffRMbCCMfCCBbCCCFSSMFfFCBSCbBbMfMSFfSHSFfHFRFBMbCMHbFHfFfRBCMRSFRBRBbbHMfFbf#
#CBbbCbCffFHfMHMfBMCBCBSBHbSFFBRbSHRSMRFFSfSMBbFSCCRHRbMRfFCBSFCbMHFBSRSMSMBSFMMfMMHCSbRBMfMbMFfbHf#
#MRRHBffBfCfSBRfHSHSfSHFFSBbfHHbHMBMRbCCMbSRRCHMMHBfBbCHCFCMHFfBFMSFHbHBRbHbHMRSbRSMCSfMMCbMbCbfCbF#
#FfFbHRMFCFSbfBHffFfMBfFfMFSCfCRSBCBFRHHfBFFHbCCMSCbMRMRMbMMMFMFfHfBRBBMBCCBCfBHSHBBCfbCHRFBMRSbFSf#
#RBbbbBbRSRfbRCFbBCSbMFFBRbBHBMMCCCMCCbFSFCBMMSbSHRbFbFfFFSRfBBbbHFSBBRSBMFBfRHCHRHMfMSCMFFMBBBFSHH#
#BMSBHHbHBFbSfBfffFFfRCRbRBFbfMbfbFfFRFFRFfMfSRbbfCBSBMCFBCBCFCbbCHSffHRBfMffHfCRHBCfffFfSHfbbFHCbH#
#BCRSbRMHFFMHCSCMffffCFRMBSCSBMfMHMRFSbRSBbHHbBfMbbHbBfRRMMHbfHFffMFBbfbbSCCbbBSBbFRBbBBCfHSSFMFSCC#
#MbbMSbSMSRRRbbCfSfFSbFRBBFfMCfRBbHbMBBSHBbRHCMCSSfHffRRSbRHbHBfFBBbCCCFbBHRSBFRfMfFbffHMfSSMSFfHHH#
#MbBMHCfHHRMMfbMFSSBRHBHSHMRRBFHBSFfBCbFBfHMFSSMFMCbfFSSCRRfBMfFSMHbRHBSBFfHMHCRFbRFfHCFBSRRMbMBCSb#
#FfbbBBRMHbFMFMbfMBSMbbBBRfBMbbMRCRbFfMbMCFbfHHCBSbBFFMCSSHHbfCMCbbFHSbFFCMbSRFHffBRMbHFHMMbMRFCHBH#
#FfFbCCfMRfCBSFMMfbSRffCRCRbFHSffbBCfCCRfMfMRfHMFMHMFFSfffRRbHCMRCSbFFRMSRbfCFCbfBBRbfMCFSMHHSRfCbB#
#MMBbSfFfHfHSBbMBCbBBfFSHHBCFBRBBHFRCSBHbHMHfSFCFMFSCSFbHMbfRRFRSFBBRRRHfBfHfbbbSHFMSbFSFCHHRbFHRSS#
#FCMRRbRSHCfFHbHbbHHFRRfFRSRBFSRCBMRBfCCSSHCRSSBRMRfBRRBMSbSRSRHfMFSRBMRCRSbbRRSCRFMHSFCCbfFFBbSMCB#
#BMHbRCfBbRFFFSCRFFSBBHRfbfMbSMSFCRBHRbRRCCfbFSCBBMRBHbBRRSHfBFSCMMMHHFCSbHCbfHbRfCRHSCbbSHfSMRFSbb#
#HBfbBRCbFFMMFCRFFBBRfFRMHMFMCMbBMSFCFBMMHbHCbCSRMfBRfSHHCfFbMCbCfCBMBHfbHSSFbHSfMMBbHHCHSFRbCFMBMb#
#RBRRbMfBSHCbbfBbMSBSMRHSFRHSBRHBMbbHfCMbbRbSMfMRMSBRCfMBFfRRFCfBFFMRbMBCCbbFMSCRfbBRCBfHRHFMCHRFCf#
#MFRCSFBBCbCbFRBCfHHRCfMMbbCCFbBfbMMFMfBHHHFHCfBBfFbFFMBCHBSBFHHCSCCfFBFSFfFCfBCBRMFBbRfMMbBfMbBHMM#
#fFRSFSfBSCCSSRBRSRCRCBfbHFRSHSMbfRbbbFSHbFMFSFBMMHHCRFRFBCfFHfRHHFSMFbRFfBRBHMCBfSRSMSbfBFHRCbfHFB#
#fRFBMHRfCHBMFRFRFCSRHCMHbFSHRSHCbRRMbbHbRRCSHMCRfMSBHHRSRCHCSRCRHRFRHfSMFfRMBSbBHSSfBFfSRfRCSBHHRF#
#RfFSHHFBRHfSHbHSfMFfHfBFHCRRRFfBBFBbSRMSSSMRbbFCSSfSBMBRFHbFFMSMFBSSMFHffHMfSRFHFRBfHbFMfSFbHCSFCB#
#FfBMFSBbFCMHbfSFfRHHfSHBBRfCbSRBMRFHMbFBbfRFHRRSFHFMSSRfffFSRCRffFHBSfMHfRBMFHfBBRHCbCbMMfBMHCRHSF#
#CbMFFHCMHMbHRCfRMfSbCSfbSSRRSffBbSfHfCfRFHHffCbMHHCBRFBSFHSbCHSBMRffFMRHbbCfSFBCCfRBCFfRSBFCbFFRSR#
#BSFMRRBFFRCfSCSCCMHMBCMFSFHFbFFbfFBHRbSfFSCRCFFCSSFCCMFRSCSbbFFCSHMHSHSHHHBSRFfbSMMBFbBBSbSBRfbBHS#
#FfbBRMbfFRbFSFCBRSHbBSHbbMFSfHRFFfCbBHMBFbCHSFBbHSFfFRMfFRFMffMHRFfMFSfSbCFHbRfCRCfffbMSHHCSMHRbCF#
#RbfBCRRHCSCBBHSHbRCBBBBHSCHMbfMFRHSSCBfBRBMRfHMCfbMbCfMHBBCBRBBbFFHSCFSFMRBfFMFCCBHRBSbHSSCMCSCRfF#
#MMMfFHSfSRBRFRRRBfBMMRRRMHBFRSSBBRCSfCbfHMMBHMSSfMBfBSbHBMHBfBSHRHCHCbffBCfFfHSBHMbBBbHfMMMSSFbfbf#
#MFCFRRMFHSfCFRSCfFbfBMBFBMfbRFRFBCMFMSSFSHRfRHBfFFHMMRHSHMMfFBfbCSMMCCfRSFbMbRBMSMbRbHHBHfbMSbffbS#
#FFRfCHfMbfBFCFbfbMMHSfBBRbBBSBBRRRBfSbFSMMRCMRMFFFBMBbfBMbCHMRbMBRMMbBFHHCHHFFHHbFMSbfCfMCCbFSHfFF#
#CHBbbMfFBFSHBHbbfFCCfRHHSCCMSbMBbSBSHbSFCCFCFMSFMMfSBBHFfBFHFfSBfCMMbHbRMSbHCBbbSfMBFFCBHRMHRCfBCM#
#FBSRMMFfRSRbRHfHRbbRCfRFMBBFFSRMCHMHSRMFMbFRSfBfFbSBRBFCSBRFSCHRfBCMRbRbbBfCfbSRBHbBBbBSRMHfBMbfCH#
#BMFRFFfSbRCCMBfSSbSRfbRCRCMFbBCFBFMMSMRMBBRMBHMSRRfCBMbbFRMCBfCHSFSBfBCHSffbRfbMCCCfbRSSFHbfBMCRHH#
#CbBMMHbfSMFRbFCHBbbbbFCBfbSFHBRSBRbFfHFBCHFCSRbfRFMCMFHRBCMFMbBMMHbfHHfHMMMMHSSRCFRRHHRCSMMCBbfbRF#
#FFRfFSSSBRBBFFBSFfFfCfMBfffMRBHSCRbFRFFSRHHSHbSBSfRBRRbBFBSMfbSfFMfBSSSRBbbMSBRfbBbbRBRfBBMFHFfbfb#
#FCMbBfRRSFRRFFMfSFfMSCFbCSCCRRSBfCCSFSRSRFfHBfCMBfSCfMfRCMfHSSHCMCMbMSMSBMFFFbFBSbSRFBHfCbfHHMRCFC#
#bBRRRCSHSFBSBbHfSRbFSfHbSFSfBCMSBMRMSCBMCHbHFSbFFfBBfFFFSbFSMbRHMRFCSCRFMRbfbMSMMRSHfHHRbBFBBHffSf#
#bMSBHRCCHSMRMRFSHMRSBfHBfBfMSbRRBCfFbHHbFHSHCFfCMBRRfbbCHMRSRCRbbfMSCfCRSFbHSHRCbFMMFSSMFBRBbFFHRC#
#HFbfFCCRMRSCfMCRBFMMMFSHRCbbFfBMfHMMCSSFBHFFSBRfSFMFMSBSMMfCFHBRfFbHCCCBHSFBBSHRbbMRCSbHHCBBfbSBbC#
#SBRSMRfbfCffbBfbMfRRMFfBRbMbRbBBFFbSFfCCfMBRFHMbMBHRBfbMSFfBSffbFFFRFCMMMCbHBbMCbMfHbFRbCSMFSHRBCC#
#BHBbfHFCFRFbfbBBHSbbCFSHMHCbRCCSbSSFfCbHBMCFHCfHSfHMSCfFHMFfFFbSHMFbSCbpCbbffFCfSRMFHBRMRFSBHHCfBM#
#BfBCRBCfHbFfFFMbSHBBRbHbHbBCbFBfFFbHSFbFHCSFHbBRbSCFMfCBfbFSHbCfFbFSBffRHRfHRSMfMFfbCFRBSfRbFBCbbS#
#bSCbSHRBfFMBBbBfbMFHCBBRBBCbSMFCHfHMfFRMBffRHbCfbHFSCfBfBSCCMMbHSbSfRHFBRbHCbbBfMfFBBFfBCHSBbMRfFb#
#CfRSBfMbFFFBfSHRCMfFFCbSBSbHfBCBFbCHBSfMCSFCFBSSfMFbSMMSfRbMHFbCHfSRHMCFFSFbSFSHRMFCSBMBFbRHBbSbfS#
#CCbFSMFMCCRBCSCSfHbSRfMHHSBbSBFBBBFHSSBffFSCSCRFFHbRfffbbRHHfHSMfHHfSFRfMMRCRBBfCfMFHRFMCbBRfBSSMH#
#RCBfRffMbffHSCFMSFbRBbMCfHFfBSMHMMbHSBBRHSMHbHMBBHMFHHMRHMBbRMbBRMBCCffRHRCMHRfFbFFSCHMFFMHCfFbfBb#
#RfFMBSSMSRRRRBMRCHSBBMBfRBHRBFSMSFMRMbFfFCbRRMffHBFSFffRbMSBRSMfMFbbMfCCBSSCBHfFbRbfBHFHCCfBCSbfFb#
#FFCfBMBBMFHbCBfCbbbCfBFHMRfFFBRRbSCbSMbbRBSMHbMfFbCRHRRRfFCCHSfBBFbBRCMHSFFCBBCFbBCHBCSbbbRCRRbBCS#
#HCbMMSbCbRRRBHMRFbRfbfBCHSRHHfbBCRbRRSBMHHfBHbMMRRFBRRSMCCHMMRMBHfFSbCbMHMbfbFRSbHHCbSFRFSHRbSFRHM#
#FBBHFHBSRRSbMFFRbbMRMMSRRBFRRFBBbMFMRbSfffMHHHFMBHBbBBHbfRFbHMCRbRCbfMMSHFFCbFCfBMbCbRRCBFFHMMCMfC#
#MSHRMCSHBMHbRfSSbHHSbSbHMfFMHCMCSSCbbBBHHHSRHfMFRRfRRCFMfMbMFFCFfHRFRFCHRHbCBRbBBSHFbRBbSMfbCCfFfM#
#MCfCCCBBBMSHCbRBCFHbBfBHSBFMFCCSCfBCMfFRRBMfMfMBCfCRFHBbBFfBFRHRFHbRBFSRCCfbCMFbRfFCMHRBHbHbCHHFHC#
#FSHFbfRBMbHMHSSSMMMfFMfSRMfMHHHBMRMSHSHFSMRfFHMRCMbfFSFFBRMFSRSMBRCFFCfBFMCbSCHCBFSBSBBSMbRSMbfMMf#
#FMbMMCCRHCSbfBBCFfCfHMBFbMBfbFHRRRSSBRHMCMCCSCMSBMHBfRbMCMRHBRRfHSBFBfSBMBHCFRCMSCBBFMHHBffFbSRHbS#
#CCSSHfHCfRCRbfbRbffffBHBHBFCSHMBBBbBFHSCBCBRHFfHMSCbFRMHFSSCMfBBCbFSSbbHRSbHfBSCRFBCCRFbSMRHSFCRSM#
#SHMSSRFBHCbSCfMFCBfCBHSbBHBCBfCFfRbFBBFMfSfSFFRfbbRHHfbBHBMHSbBbHFFfBMfSSHffFBHBSFHfRMRFFMCCRRRFHf#
#HCMRMFbFSCMSSHRMCBbHSBfMMFFfCbfBCRHSbbffMRbHMSfBfbSMbCMBSbSRCSbMFMBRbfbFMBfHbbRRBHCHbBRCCbFSRbbBRB#
#SbCHBCRRMSFSRRRBCSFCSbMMCfCHffMbRBHRRRSffRfBBBRfFMSBMMRFFbbBBSRRFSMCCBHCRfFHSSSRRbMHRRFHRRHfFbFSSb#
#RMSSBffMBHCbHbbbFCHSRHMBFSMBCfMFbBFbMHMMFFCMFSfBCbMBRCBfRbRbRMSHfFHfFFRBBFBfbbCCRMMRSbHfSCfFHBfCFS#
#bCfffBCSbSfbHMfRSSMFMSMFHRfHBBBFbMbCBRBRHbBBFFSMfRfBHCSbSCbMFfMbfHfMHHBSfMbMRFRFRSFFMRFSBMFbCbCRHb#
#MBRHFfHfHMBfMHFFCFHbFMMHBHFSFSSFbbCCMfRFCRfMHBFfBMFbfbbMSbbfBFFCMfCfBSfbMBHMBFbHMCSfMFbHCRMHbHCbfF#
#CFBBMSMHBCHHBHRHRSffbbBMbfHMFHbfbFBHFbMMMSHHFRfSBCSbCMBbFMbMbfSRCFBBBRMbCbfCBHMbMBRBBCbSRRBBMFFRBM#
#SHfRfHMFbMFCSBbSRbMCHfCBSfRMbbRMBCFFfRfBRBHBFCCMFMMBHBfCRBffFHCMfHbfRRSfFCRBFRSBCCSHSHSCSfRMCRHHSf#
#FSbBMRCSbbBBBBSCRCbBHHRSBHSCSSbbbbCSbSBSFMbFBCCCBSMBHbBBbRFSMRFMHSHRFSbfSRfbfMbSBfFMSbHSfRSMBHCRBH#
#RfRFCfbBMBMMFbHBBbMFCCHbfBBRbBBbRfMBfBHFSbfFFSCMCbCbBfHbbHMCBHBffBBfHHbFMMRFRFfBRCCMCBSSHRCRSSMBbS#
#MRRFfCSfBRSSFFSSbBRbffCMCHBbSfSMRMfMSFfHCfRHbfFFbRCCFFbbBCbBSSFRSSMSHfBRbFRSbFSFCSFRRSHMCSbSfbffbf#
####################################################################################################
