####################################################################################################
#MCbfbFBMFRMbbCHSCfFBBBFCffRFCfMfCMMSRBbSFRCHFRMBbBfBbCFbMCMfMHBbCfFRMRFfMMfBfFbbbSSHbMbMCMRMbMfHMB#
#MBFfCSCSBCffFbMRRRbBSfCRfMMSbHSbBSMMfBFfFbbCHHMHbMCFHSBSfMCfRFffMFSBSCHFFRFfbBCCfFBHBSRHMSSMMBCFfM#
#fFMMMBMHSSFBHCRbfBMHFbRBHbCbMSfBBBRHSHFHSHMfMpRSFSHbbRBBfCCCRSRHFbHMbSRCSBMBffHMFfHCCCbRBRfHBBfCfM#
#bHffbHfMBSFFRMSHSSFMMRbRCFHCBBbBMfBbRHCbCFfSMBFMHBBCCfbSFMMRHbHFfBHbbMHffSMbCMfSbBMfHSSCHSFFRRbFbf#
#CBSbBHBbRCHBfRfHbHFbMCHSbCMCCMBHBbSFHSBMFfHbSfHFMBRBbFMfBFbRbbFFRFHfBSBHRHSHHMfbFCSFFCBHFHCHMRBSCB#
#FBBFbMbRbMBBSfHbMSbbMHbSbfbBRHBRMffMRRRSMBSBFRCBHFMBCSCRRbSFFFRfCCSHfSMHbSHbbSMFMCMBBSMRHRBfRbfbFR#
#RFMSRCBfbffBMBfCBfffbBbHfBbbSSCfRBfCHSbHFRMMBfRCCBFMfBbFCfBBHRCRfSSbCHfCbMFMbCfBFSMbHRHfSFfFfBBCHb#
#HfCFCBRHSSCFCMHBMBBfHSMFffBBSFMMBBCfHfBfHMSRSFbSHBbfHCHMSbHfFfCBCfbFRMRRHCfFMfRSHfCfbRbCFBSfFCBfBH#
#RMRFMHFSbbfCHfHbSHSSMSfCffHMHFRRfSRFFbCMBBfSMbSRMfRMBBSMfbFbBSSffHCCFRHHFMfCFBMMBSMSMHSBBSBHbRfFHC#
#FBMBSBCBCFHHSSHMCRBHfFSbRbRHMfbbBfMBCSBRFSCMBBBSfMSMBBbHSSMMbfbFHCCSRCbFFFBFBSFRFCMBbSfBHMRRRRBMFC#
#MFFSHHSbFMMHfSSHCFRCCRbSFbbFRCSbCMbCBCHFBMffMHMFbMCMFHfSSBbMMRbMCCSBBBfRfbfRHFfSFMBFMbRbCHRMHFfbfC#
#CCHbSbRMRFRSSCfHCMFBFHFBRMRbfCCSCFbHMFSRbMRCfCHbHbBCSCHSMRHBBHbMbRCCBMffBbFHbRCbMHCSCCHCfFCRBbbMbC#
#SRFfFRSRCCBbfHRHbCFCMRHHHMRMBRfHHFHfMRCSRCSSHCSfCSHBFRBHMCbbBSFffRCMFBRbFSfMFCCfMbBfFRSHSSSCbfHCFS#
#SBRMRMBRSFSHfBRHHFCfbfBMSCbfCFBRbCHfbMBfCHMFSMBMHFfHBMCHfMHfRbfSRSHHbCCHBHbFSFHRBHbfMMBbRBCRMfCfbS#
#RBMbHffRRHHRbCCbfRMSFbMRMbfMHFBSRbMBMFRSSBbBfCSHMfHCMSBMSHffHMHSCFMRHMRFRCFFfBRfMbMHFSSfFRMRBBbfSM#
#fBfRMRBbFBCBfBCHBffbbRRHMfbbMRRfMCHfbHSMbffCCSfSCRbCbRCHBMHBFRMRffFFMBbRbFRFBMMfRBHbMHBMHbfHBBRFHC#
#BCfRHbCMHCCFSBCCffSRFMHSSBSbRfBSfCFHCbRMFRCfRHBFBSbRfHfbMSFRCffHFfMbCSSfRHFRFRHBBRFSCHfBHBSRfCFFBf#
#HCBSMfFfCFHSbHCfMfMBbbMSfFSBMHBSSfBMffFCHbFbFBHbFCbBHBMbSRbBBCbFBSbBMFHHHbMRHHbRHbCFRCRFfMHfSBHMMB#
#HFBbfBFSBBRCbMBBHBFbBfRBbRMRMSHBMCCFHRFCRSCMHMbRSRMHHRRRffSbfRHMRBbfBbFCHCMFbBBMMBSRMHHCRCBMRFfSRF#
#fCHfMSbfFfBFbHSBHFBSFRSHBSBHRFBSBfHMFFSfBSfMffbffHHFfSbBfFMMRMRCHfBfFSHSBSbSCfFMHMMfHfbCRbbMbbMBbF#
#HRSHBbfFCfCBSSBbBMBCfFSbBBfbFFFfRMbfRMCRBffRRMRCBbRSFfBHMBFHFbSbCRfRBRCHSbfRSbFfRBSRFFMMSBHMBBMHCR#
#fbFHFRfHSRHRfSBfMBMFfffbBbbbFbFHfRFBRMSHSRbbBfbFMfFSMSRfFMFSfSCRFbFbSHFCRfFCRbRCBRffBSfbRSRFFRCCHB#
#RBFfbSCSffRFSSSbHbMFHHSCMFCFMbBCRBSRHCbHRMHRfMHCfBSMbfFffRSCfbBHSRfbSFMHBFCHfSMffCfCRffMbFfSfRCFMS#
#HHBHMHbMCBHMfFfCSbMFffCCRCBMHFRbMMMRCbfFbHCBbbSbCfMSMSBBfffCBCfBSfRbRFSCCFMSMRFCCCHCFMFCSFfFSCfRHM#
#HbFFSHRBMfBBHCMCHSMFRRSRSMbSffHFbBFSFbCFfFHMCCMMRSRHHCCfFfFBbBMCCHBSBbCbfMMRbbfCBSfCCFRFMRbBHMbSfC#
#HHRfMSRBbMCRFRRbfFBBMSbMSCFFSFfBBfRFRFMMSHSfFMCFSbMCfSRfCCRHbfFRBFBFMRCfHfFHSffbHFMHMCbCSMCCCbMSbR#
#fCbCCbSfRMFfHSRRFMSMRHMbbCRHRFHbCCBMfHfHCHFfbbBSBSFCCFMSRCCfCBRbFRBBCSMSHMRMBMHFFfRRHCBfRFbSFFBHSC#
#fRRCRHHSbSMfBMSSRfMHBMRRSfBMFCfCBHSfMfHRbCMHFfBfBRFRfSCBMHbMSfMMCFCCMSSCMRFFMbFRSMfBSHBBMMfMfRMCHF#
#BRRCRBffbRRCFBBbRCRCbBbFMSSRCBHBSffBBMBbFMRFHbMFHBRfRMbCHbbCRFHRRbFHMMCbCCHBHBRSRbbHRHRBffRRSSCCbS#
#bCFRBHSBRHHSbCRFbBCRCCHBbSHRBSRFMSMMMBHCBHFHbHFbBFCRHBSbSbHRSMHSBFHbCCHfBSBHbMfRBFMFRCSCRfbMMHHFCb#
#FCHbBfHCHFSCCBCRFMffRfCSSMFFBSbBMMCfBSCfSMCSHMbfBSHBbHbBFbBMFbfSfSBSHBMBBRBSbMBbbRMfFFMMSbMbSHfSbH#
#CfbBBFbBCCRCSFRHffRRSFfFMCHMbbMMBfSRbCSCMSffCCMRBHbHSSfMRMBbFSFRSfRfSMHMCMfCBbfHHSRRfSRBHBBfCfRHfb#
#RbBMCRbBBfSSHRCRMfSBffbCfBHRRBffRMHMSfbbHfFHMMfSCRCfMMHRBBCCFRMCRFMSbMBBRfFfBCbFbFfRHBSBBRHfBFfRSC#
#bRCBfBCfSSMbRMRSbSBFBFMHRbCfSCSBfMRSFCCBRHMMSBSFFSSbFbRBRRBHBMCbbFHFFMBBMMBRfSMSfSRBHfMMRBMFFCMCCb#
#SRSCMfBfRRFCffCSbSbfMCRBBHMfCRSfBfMBRBRSFMfHHFRMfSMFCBMHCFSBBBfCfHSFMCBBRbMMbCBFFbCRHMRbRFbFMBRfbf#
#fHSFFHMHFRRBMRfCRHffSFfSHHCBfRHSbBMBfBBRRHHRBHfSSMBCSMHHRFffBHMBSCbHHFfHCFSSbSCMBRCSBFMCBHCSbRBCHF#
#SRRHFSHCSbfFCfFBMRSbSbFHHRFbSBCRSbBFBCFMRSSfHfHfMfRCHbfCbRfSCFBCMMRfCbFFbMfFSSFCSHFfHCSfBBfCbFMHbF#
#MfMCbbHRbbfBRfFCfBBBBbSCSSRSSMMHSFBSRRSfRFbfMMFfRBSFfRFMfMMCCbSFfSMCHBRHbHMbSbbSBbMFSFSBCRBMCRMbFB#
#HMbCHBCSbMFMMRfbHSRFfSMffHbCfSHHRBHfMBHHRSRBMMMSHHSSRSfbFSCfHHFbbHfBHfBSSFMfHSFbSBRFbfBCRSFBBbFFff#
#MRBfBbBRFFbSBBbfRBFSFffFMFBHMSFHCBRFHHCFbFMfFfbbMRSbbSCBFRSMSBfffFMSSCHBFMMHCCBMMMbfbfSFfFbMSCRMCf#
#RBSbBFMfFFBbBFFCHbCSMHRMCBRFBHHFRFfCRCSHfRbMSFfSFHfFCSBBHBfCbBSCBCfFFCbbBbBBSHfMbHFBbfBCCFBCMFFCHM#
#RbfHMMbMfBFBSBbRBbBBfSSBMfbfBbMFBCfCBFCCFBFfSfRRfCBFRCMHfbSHbBHCSHHHMMHRSFBHSRHfbSSFfCbSBRCbHBRBCb#
#CFFfBRCCbHCbfFHFSbFBBFBSMbFfbbfbCSfSRbBFfbfHfHbfSBHBMCHbRffCHSbfMFRHbBSFCSFSBHfbCCMCMSBRFHbCCBFFMB#
#MHBMSfFMfRbSFBSMBMHFBRSHBHBfCSbbRBBfSBSMbCHbFfbCMfRFSCSMMRCSFBfSbMFCfSRfHSHBRSRfRFCHbCbMfCRSBFbFBM#
#bSBMMbbMHfRSbfCFMSbFFSfSFCbRHMFHfffMSMSbHCCHFHFBMfSfbbCMRHfHFbBfFSbRbfCbFCMCBfMFRBBMBMMMBFMMSfFRfC#
#FCfCbfbbCSbFRMMMCFMFMCBHbBBMBfSMSBCBCbMSFBbFBHbfffRbBBCSHffHRHFFSBBMHCSBHSRfRFMfHCbfSMHbSBMCBFHfMH#
#CRMSbbSCMCSMSMFRSffRSSRbHHBfCHSHCfbfFfbBFfBFBHbBbRMCBMHBHBCFCMFbbHFMCHRMRCSSCCHbCBbRfSbSSMSFMCfbRM#
#FMRfbHCCMSRCSSbSFbfCCCRSbfCBBSbHRSRBMBFCRMCMFbRbFSFHfBCHFMHFCRfHCRHRbBSMSMRbBFMHFBRSbBfHCHbSHRbRbf#
#CbFBRCRFFSRHfSSfHRbFCMRCHFbMRbfRCbRCMSfMbCfRbCfRHbRCRbSfHMSSfRCFFCHBSBSMRMfBMBRMSffBSRHBHBbMMRbHHB#
#CMbRRHSbbSHbSSRCRMCBSSffbMSCBFCRSBFMSfHHFSHfBHfHMbMBBHMRSFBFBfMHFbRfRFCHMbHbRSbSHHHbMfBCHFfMRbSHMH#
#MRfBBCMCbbCfCBCBbMHfMfFHBbbCbCSbCfSRBbMSHFRFFFCbHRFSCRRHBSBFbCSFbbCRSBMMMFfCbfMCCMRFbSHRCCBCfFRfRR#
#FfSBBfMBfCHBHbfFRfRHfCBbRbFFMfRSfBRBRSCfSRFfFBBBRSRCMHMBFMMRbbRRBMBFRfSRBMHHfBSFfMSCRBbCMRRBHfBFMM#
#FFFBBBBCffSMbfCSBRfHFMHSfffFFHSBCHCSHFMFSRMRBMFCHHRbRMHCHbRMbfMCSMRMBFRbbfFbRFbfBHfHRbMHfMRBCMHffB#
#FRMfBfBSfbRCRRHMHfSHFSfbfCfCfCFbbSRbMfMfRfRBSFbBRFfRRBBHfCfBbffFFfRSFMHbRSMFSBBBBRfMFHCRfHBSfMSHBS#
#HbfbCSRbBHfRffBHBMSRFFFRHbCffCbSCfFBBFMFbHRMSSfCbbbbbCBMSbBCSfBRHMMCbRBBfRCBMSHRfFCFHFRRBCSMSRRfRM#
#BfMFfbMRRBCFRBHBfMRbfMSbBHFMbFMfCbSFbfBFBFbBfBbFbRFbHSFSFSSBCHMSHCbMBBbFMSbbfMBRSHBBBRCbBSMbFHFSCC#
#BBFRffRMRSMHHHRRSMHMCCRHFHHfffBHMMFbFbCMHHCMCFCMfHbFHFSBHHSFMbRMbMBMCSBMHfHbSBRHRRBbMSfRSFHbFFCMFB#
#fHMCbFSHSFSMBRCBfHfbCMBFCffBbbHRFBCBHMfCffbBSFRHHHFSMRbSRBRCHFbHBBMHCRHSBFHBRHbHSbBRfCBbHffCCMBCfR#
#HSfMHRBFFHffbCSSHCRHMBHCRSCBbFHHRBMRHSfCHBfHFHSRCbbfCfCHHSRFfHFMbCHSCSSbBRCbRCRCbfBRSBbRRfSMHHBHBB#
#bSFbbCfbCbCCRFBMRfSMMHbSHRFBbCRMMSCHBfCCBSCMCbRMfHBBCHHCHFHbRSMHFMBFHSHHBBBFfBFFbbCBfCCSCHSRfSBbbH#
#BMRRSFRHBFFMfBbHCRFMMCCMRfffMRCSfRBHHMSCFHbfBBHMHSRSRRCRbMbBbMSHSbMfFfFRSBMbSRCCMHfbMFFHMSRbMFCMfR#
#fSfbfbMRCSRBRCSfFHFBfRffHfMbfMSCMBFSSRHfFMCMBMbFBHMMbRFCbFffSbfMCFBfSRSfHbHMSCHFCHFRSBHbMFFfCCFfbb#
#bHMRCMHFHMRSCBfRfCFCfBCRbHfFBfRCfMSHFCfRSHFCSCbHBFHBfCbCHbSfSSFSCBbRHCbRFMHSSMHCFbFBbCHHfBSMMCSRRH#
#FSMMMSBfRCfSSHRBCRBMbSRFFSRSbCRHSBBRbCfHSFFbBRFSBfMSBMCSFSRCCbffHHHFCCFRFfRfMHCfCHFBBCBbMMFRbHCFBS#
#FRBHHFRfHBSFCSbfHbBRBRRCBRSSCSHbMSFCCBCCFCHBBffHSFHfSCHHFfMSFSBCBbBBFbMHCBfbMFSHSFHRSbCRfHHbbFBMfH#
#BSbSBSRMRMFCMffSMHbbBFFMSRBMbHbCRRHfRCBfRMbBCBBfSBHCSfCHBbBBCHCHBRSRFFBCCRRfHMbHRMfSCFRFHCCSRMRBFf#
#RbCFbFCbCCbRBfbCRfCSCCbFbFbbCCCfbfbRCMRfRHSBBfbHBCFFbHSSfBRHBCMMSbCSRFSMfBbfCRMbCbMCMFMHbfBfHSbBFS#
#CRMMBfCCBfHfMFFFRRbfMBHRBRSMSSBCSRSMBbCCMSRHRbFBMSFfCbbCCbSfbMCHFCbfMCMHRMSHFMMCMFHbfRbHffSSMCRHfR#
#MbCBBHFbFCbCffCfMfbFBBfFHRSSbbbFCCSSHHHFfCSBFFffbRRRbFFfbHHMRFMHSfHbMfCfSRfFCCbHFHMRbBCRFFHMBRSMbC#
#HBHSCBbHSCFMfCSfMSHCHFSHHbFFBbHRRHRHHCRBRRfSbBfFMRFMfMfbMBCRbRFHCfRCfBFCBBMCFBMHfbFfBHFBSSMMBCHHSR#
#CfRCMfHSfbSCBfRCCbFRCMFbbCBRFSbMBFBFFRMHFRfBBSMCBMRBCSHFFBRMfbFfCRfCfHHbRRFBHCFHbMfSMSbRMSBBfMfRHH#
#MMSBHMBCHfFHSBFfMfbFCfFBFbfFRBbRHSFRBCRHFMbFbRBRfSMMCfSffCMHRRCRbMMFSMSCSBMFSHRHRMSBHCMRBMCSSRSCBH#
#bRbCFSbHMBCfMMSHfbSMffBSSRfFFbFfCSFCHMCCMSRFSSSBFRSMCHRFBBFfRbRRHHCRbHfSBHSBFfFRHMfHMbCHCMbRRFBRRS#
#BMBRbFMRRCMBbbMMFfCBCBMbRMRCBBRRBbBFfSCHBSBCfbRbCHfFBMCMBCbfFRMCbMfBCMSBCCSMBBfFRRbFRCBSSSfRBSfCSB#
#bMFBfSBBSfRRSfSMHRHCHCCRFHBRBCHFHHMSbHfbHfHffFSbFbffBbRMHMSFFRbbfFCbFCfMfffbFfBRRRFbBFFMRCHRMbRHMb#
#SMbRBbHSSfMbFCBbfBSbRFfCCHSMFRbHFCMRfbMHBCHHRSSFRHCCfFBRMbMRMBRbSHCffCbFRbFSHRMHSRCMBCCHbRHHRRMCHB#
#bFRRbHMMHRBbRBbBFRfHRMRBFfFSBBfbCFMfbSRBCCMbFFBffRbfbfSRSfbbCfRBRMRHCSHBfFMBbbRBFSRSMffSFCRbSbfRRB#
#RfRMRfRRBRMbRFBHSBSBCHCHCFCFMbHRBRfSCCSSSFSFbHFMMCHBfHCSbBbCRfRBMfRFCBfBHFCFMBHMMRCCCRMCbSRBFMMCfM#
#fSMSSHfbfHCBMfRHFfSSHfMBBFCCRbRbCSMFFRBBFSbCFfRSMCSFFCSRFRFfCCHSbSRRfCMSBCSbfFSRbRHfBFMCfMCRMBfMbb#
#fFbSHBBMFMHCHbRRCFRCbMSBRBHSFMHHSRMfFHBBRBRRffRRFMFCCbCbBCCRFHMfRSbFSHMFBRBHHRCCFBCSHBMFbbMbffHHfC#
#bCMbCHSRRFSHCMBCCfFBFBSHFMffFSCBbRFFMbSCRbRBMCRMBbBBFRRSfSbCBfCbFffSMRfFFMMBfSRbBFFBMbbFRfSBCbHFbR#
#SCCRSMFFBbBBbfCCBFbRSFfSfBRBRMHRBHfFBRRHBSRbfFBbfBSSRbMMHBMCRBbMCCHfCfHFMSbMMffHMCBBbfbRCFBMFCFRfR#
#FbHBRFHHFFfMCFBSBCCbbRBHMRbMBbfHSRMbRCFMFbFCSSSSSfRHCSMfHffFHfSSfHCbbbBBBFRHMBCFRfCHMFfSFHBCMFfBRb#
#FBSRHfFbbfBSCMBMbBfHHSBfSBBfBfFFHbMbbSCRCCSMMHSRFFRHFBFSMbMbRSfSMFRfMSBRbMRHCMRSMfBCCBHbMbCCFSMRFB#
#bfCBBfFffbCFSfBbHBHHMCFMCfHSbBHHCbSbMbMfSFMCMRHbbHBFCCMFMFFHHCFbFCCRFMBHBHCCfMMffSCCMbSSMCHMCCbbBF#
#RCfBMCfFHBbFBMfBbSSFHFHMMBbCBbMMBRCfbfCCRHMfHFMHbRHbSHHMRfbBMMSbbBFSFCCMfHBFFfSCFRFFBFBFfCMfffRCSR#
#BMSHSFHHRSFSbCfbBHHfHFCMbFMRCMHCMRCRMRbFFHCRCbBCSMHHFfMSfRRMSSSMFHHBHRMRbHBFFHCBFSCRCCbbCfBfCfbBFC#
#BHSfHfSRSHFfHBSBfRCFFBHSSbfbFfBFfffbCfBfbfFMSHSRBfbCRFBMCCSSCCffCbCRCCCbCbfBMbHbCbBfHMSHSRHFCSSMBR#
#fHSSFHbFCbSMSRbHHbRMRFFCfMHFRFHbMSHFSBRffCSffHHMCbFbfRbCBfMbbRRBBBFHMHFfRSCfMCfBRSBfCbFCbCSfBfCMFf#
#HHBCFFRFfHFFMfbFSHSSMMHCBBBBBHbFMCfBRBbRRBRHHFbBRSMSSbBBBCBfBMfSRbCMFbbfSBHfbRFMfHHbBbBfSMBFbHFBbR#
#bSBRCbSfbfbRSRRRBRfFBFCMRfHHbSFHfMbMfCFMHFBMHCCCFMCfRBCSCSRCfFbMSFHCSHCMHfFMMSFfBbMFbHFHbMfCBfRSbb#
#SBfBFbMSBbFbfbFHSHFSfHHCMBRFfHCbCSfRCfCbBbRBCFRbbMHfHMSHFbCfMMfSBfCHMMbbMBBBBbBCRBHFFFBHfBbHSRRSFb#
#MBHBFbRBBRHFHSMbbbRSRfRffFRBRBfSCFfSbSHCHMBBCbfCBSSHFSbbCCbRSbMRMbSCSRRMBSRHCMSfbRCCSfCHSBHffbRbSS#
#MRbBbSSSMSMHHBSFFFFCBFfHRHFHRfBbFSSRFfRRCRCCfHRfRSFbbSRFCfFSbBSSCMRFFBBbSMfBSMfFMSbHHMbfFRMHMMHRBR#
#HCfSBCFSSHbCFfCSBRCfHRMMRBBRFHHFbbFffRMbBCHbRbSMBSHMMCMHSbRSRMCfMHBRBFMBfBBRfMHBSSHHRBfCSBMMHSBRSF#
#bRFHSFffHFRCCCRCFHbFbSFfHMRCbHMBHCHbbSCBCFRRCRffCCRfMRBMFHBfRSbCSMRbfbbRHBRfbCFSRCBHMMCBMbRSSbCbbR#
#CFCRHHRSHSRCRRbBFfRCMFSfSCSBSFHFBHHFSbRMBbHFMCMCBCCMBfbBMCFCMCFCBSCCMHMRBbfMCFbBMHRHBHBMHMbSfRFRbf#
#FbFbBHHSSRFffFHCBHbbHHMFffMCfCMbMfBFCHRMSFRSMHbCCHffBHMfHCBRMMbHRBbMSCSRFCRfSHRFRfCBHbRSCRSbHSFbSC#
####################################################################################################
