####################################################################################################
#CFfMMBfHRbFRBSbRBBHSMFMMMSFBBRfSBSMFSRSCFbbHSFSBHFCSRMCRSBCHRBFRBFCSfBRbRBBBBFMFBRbfSFCMFfRHRSbBbS#
#bCbMSMFbbfHSfbfCRCSbRRBRFCRfSFfbfMbSCfRFRHHHFBSSHMFRHCfCHCRMMBRHBSCCFBSBRFBCFHRFRBBMFbMMHfMFMMHbHS#
#SCHSMMHBHFFMRHFRSbFMfbMbFfMfFCHSHFMfCbCbSfbfbSfCSfRHRRHFCbRMMHFCFRBCMSCBCBMbfBCRfHCbbfRHbSHHCHBRFf#
#RFHMRHbHFRFFFMMSSbCbbMMFHSFHMbMHHfbMbRBHSCbMMFbRBSMfbFHMSbSbfSRRBHfHCRSfRBBFCSRffSbbRbfMbFMFRSfRCC#
#RSfbBbHMRffFfbMfbHbSCSMCbHMbRHbCRMbHRSCCFbBSSHBHFRFffRBfRSCbMRFMMffbRBSHbBMMCMBSHMBCBFfMSFCSHFHfBR#
#MbHCBRfbRCSSMFMFfCCRHSHfRHCMBSCFfMRSSSSFBSRSBFHSMfCSBHbFBbSCCMSffBFbBRBBFRffMSbHRHHCbHbMSSSRBBRFCb#
#BCSMRbbHHHBMSfbFbFfCCFSSMCbCbHRCBbfFbRfFFHRCbHbCRRSFfMfMSHCBCFfHFMRffHHfBfRSFSFFBbBRFfCMHSfFbFCHHH#
#MMFSFFCMCfBRfCBSbSBbMBHFbSFbRfRHfCFRSfHfSCBbfSCFFSHCSMMbMRFFRSSFbRbRCBCSbbMRbRMMBMHCBRfRRFRbRRHMbf#
#SBSbRFSbCSbHCRRMFHbBRbfHbFbMHBFSBfBRSFBFHMfRfFRfBFSMbSRFBRBHHBSBfMFRbRfCCMCMBCFMbfMHFRBfCfHMSRFCFB#
#RMFbFHRfHFMBFMRHMHBSCSbfbHSfRbbbRRCMMRCSBCMFHMMMfSCRbHbHfCMBRFHfSbMRCFbCRCfbCFSbFBHCfbMRSHRFRBHbHH#
#bHSRCRfSMFMBFfMBMFCRMRCBSbCFfMbRRFSffHSCSSBfRHfCCRBBCCbfFbFSRSRRBMCBMSMBRHSRRMHMSRBRFHSFCffCCFCbHC#
#RCBFSRSSRSRCfRRbMCHRBbBCfCMHFBCRfBbMHHMBSbFCBRBBHCFCfRfCfRbHfMfSfSfRSbFfMbRSfMCbSMSMMfSCMBCSMRBSCS#
#CBBMRfRfMHBbSFRRbfBBFBFCSbfRFSfSMCBbfRFFCHbSfRCRbBRHSbSMMBBCSMBCSCBCBbFfHfMRFHBCBHbfRfCCBSHRHRfCHB#
#MSRfRfRRBCFHSbHRSFFCfHHHCSfBFCbFCbMbFffFbCfbFMbHbBMFbBffHMfMCBMHSSBCCRFCHfHbfFHRbSBSFbFCFFfCFMHBMb#
#HCMSFFRCbMMSfCRHCCfMfSSfMbSfSFRSCBHCFRBFMHSCFfHHRFbSffHCbHMRSBffFSMCRSbBFFRHCHMCRCSCffffCSHfHRbHHC#
#CFfFSbCBSRRMFRBHbSfSFSHRfbSSBfFSBHHFRCMCBRRMSSMHCFSCFSRBBMbSSCRCCfHSbfMbBMRBCCMfbbCFCfRbfSMbHSBRFM#
#SMBbRMRRBfCFCBCRBSfHFfHFfBRBbfFRHBbSMBRSRBMbBFHBbBFMbCHBRCSMMSHCFCRbbHMfCSfRCbRMCbRSRRSBCRCHFSMRFM#
#FFSRCCFfRSbHbMRBBbRBRMfbFSHMCHRMCFBMHSbSBSBBbBfRFRHBbSFSHMMCHfSbFSSfBHRHFHFCHbBHBbCBffbHbCbRSFHRMH#
#RbFfBFSMHFHMCFFFFCpSHMCHRHCMfRBRffFMRCRHbBBbBSbCbSFRRCbCSSRSCFFFSFHbSbBBHCRHSCbHMBbFFFFSSbfMBBSBbH#
#SbBMBMBbHSCHRfCffMBFBFHMRFFSBFRSCCBfFfMfBfbRffMbBBBMCfBRBfRSHbHRSRHCMbBBHBFHBbRMbRFMfFCMbfRfBSHCHB#
#MbMHSCfbSBMRFMSRHSRCRBbbSCMHHCfFFHCHSBRbbSSHFSRFCFfFbMFFHbSMfSMCMSRRSSCHfSFBHffffFBSMbFMfHbRMHfMfS#
#fbBMFMRBBFMSHBCBBffBFMMRFfFHCCFBRSRRRBbSFSSBBbBbMbSRCRFHSfSBfSRHbbFfMRHRRHCBBMbbSSFHRMMFHCfRRBBRHf#
#bHBSCbfFBbCMMHRbMMfMRFbBffSMHFBbfHBFRFRFFFSHbSfRbBBFMSBBMFCbbFBRbfCSFMFMHSMFBBfMFMfHHRbfFCMMRSFFRR#
#SBRCSMCbMSRHbSFMCMHBCRSSMfSBffCFFHbRFSRFbCSbSMBBFCfFCMRMRSfbbCRbSSCfCSSCFFBFFMHHfBCFCHRSMFCbFSCFBB#
#bfbCFBMCHHHBSCHFbRMbRHBFbbRfRHfHSBfBfbBfBbMSSHBbCCCHSSFFHBSMFCCCHBHMFbSMMBRMHBRCbbBFbfHSBfHfHSfbHF#
#MHSRMCRSCHFCfSHFBSCHCRbCMHSSBFHBBbSMHCffCMCbfSRRCMHffBbFfHBffRCCSRHffbFRCRFCHRbSHMBRMFHRSCSCMRBCfC#
#BBCbFHBSRMSSBHHHFFCMbfbSBbCSbMHSRHRCBBbCRBHbRSfSMRSBRFRRfSHfbSbBCRbHMCHfRbHFHMFCMMfSBCMSbRHFBSRbFR#
#HMBBCfSHRHSHSfSHCHSMSHbSffMfCRRfbBRbHCfHHfbHCBBBbMfFCRSCfBBMfSCFMffRSCCHRbFCMBCMHSRHfCSBCMBbfHCbHb#
#SbbBFfSRRBFbBbHMffHHMCBSRHHFRFbFFMSSFSBRBBbBMRbRFFfSCCbSbRSCHRSFbbFfMbSSBSBCfMRSfBbBBRBSFRbfRFFMRb#
#RBffbfFHbfCHFRbRFMMMMfSFMHHCCBfRFbSMCFfRMCFbSSHBMHfBHRRHRCbfRfCRbfMHSSCRFCSFbbfCCfCBRbCBFSCfCFSBfR#
#MRCffFbRbCMbfMFCbFCbRSFSMHBHfbFSHSfFRRHRFCHFRfCFRCfMRBHMFbSMBCfHCSSSFRFMMRRbSMfCfHMFFRCMRCBRFMMfMM#
#CHfbCRfFMSMRSbSFCHCFRFMRfSSFRSfBFMSCfMSMFSRHfCRCSRMCMMFFSHSMCBCSFHBbMfMBfMSRBSHbRCBFHCbCCBbFSFfRMF#
#HBHHMbRbMBRHRFCCCBMMSCSRCfCffSCBHHfSffHMFFbBFCCMFHBFfBRFHSbfffCSBBfBMCFCFCCRfMBfHBSMFBMBCFbSFfHRbS#
#CfSSbRMFfRBffSFMHbMFHMRMfCFBBMbfMSCHMRRHfRMSbSCfbHSMMSRCMHbfBFRSSBfbFRbbSCRCBfFCSbHSfRRRFRMbHCHCCB#
#ffRRHbMSFFbCMFBMfRMffBRRbMCCMbMMRbfSbBFfHFbBBFfRfbMMHSBSMFfHCRSHCRfbCffFFbfbbRSSffbSHfbSMbRCFCMMff#
#bHBbMRHfbRffFBRRMbFHBBfMRBRSBSMBFCbbfRFCCFCSMSSBCCMRMSBSHHRCRSCFMSSSHbRSRBbBSFFFMHCffFSMSbSMfMHMMH#
#SCHFFMHFHMBfMHHFMFHCfBBSBHBHSHRffHBFbRHHHHFFCHRfbSSffHBHBSFfHSSMHRFbbRbfbRSMbRbSMCRfbbfSfCbRRRBMMH#
#fBMbRbBSRRBHRRSBHfBHfRfbCbfMHCCFCMSHSfFFCFCSbCSMCMFFFbfRRMRRBbMfRbMfSfbCSSBMSfHCSCBFCRRRRRfSCfFbHb#
#FMSbHCHRMMCCbCBfRCbRbHfFRMSMMCFRSCBCfbSbbHbFbSMRCfFRbRbRbCfbSCHCHSBRMRBfFRfMBFfCBMSCbbbbHbCCfFHSCB#
#fCfBCCfHHHBHCCbSRHCHCCbCCfCBRbfCFFSRRbMSSbMSCbCBFbHMfCRHFFHCBRFHfMbRSfHCbBHBMFMHfbFBFCfBFMMbBMbSBR#
#bbBFHffRCBFMBBbbSMbHfMfBRHCbRMFbMSRRCMHMSHBBCfbHMMRbHBMRMRMRCFFfSCBCSbSCFfCFHCMFCSbfMffBFFBSFbCFSF#
#MFHMSbfCFHRFBFCBHFFFfSbCBMHHSfSBFMbHCfFbCFSRMbHBMSbbbFBMMHFCHBHRHfHHfMBfCCFFBMfMRHHBRFRHHfBHCffbFS#
#MbSFBCRFCbCBfRFfbbHRSRHbBBfbHfBSBHHMMHHRHFBffbHCMCbbfHfMMHbSFCBMSSFMfFMSMHRSSBCBCMFHRSSHbfCRfRbRMM#
#bMMBBHbRSbFbHHCCHSCSHRBSFBfSRHFffSfHHfbfCCBCSfBBffCBfCCFBbSMCMHFMRSHRBRfSBRMBCCfCbFMRHSHFFSHfbSMbF#
#CSfBCRbBHbCRHMCfCMRSSHCbHRMfSCBFCHFBfRfRHFfFFHFHFfSBMBBRSffSHMFBbfBbFfbfBfFCfBFFRCMFffbBHFHFfRfMBC#
#BbbCRSRbRBbfbRfSHMMCSMBBbFMbFMfRCFHHbFHFfSSSbCBCHfHSfHCSCFSMBHfSHMBfFbMRfFRBCbCbMFBMSMBMCCFMMHbfbC#
#MRbCRFCbFFFBbHfSRfBSFCBfFFHbFHRRFFbSCfBbFbHRCCMBHMHMCbRFfbMMbFfSRBRFHbMbMCHRCMCfSSfHMBfCBbCBfBHHRS#
#HHHCMRbMHMRMFHFMCCHBbCSbBFMCMMBRffMBCSCSbHSMHCFfBBHBRCHHMBRffRBHCffCSMHBMCSBCHfbbSBfSfFSFFCSfBRfHf#
#HCRFbMBHFSFBSCCMMMCfHRCCfSFFRFBHFMFfFHbbMRBHbBSfHBMHRMCMfRFRfbHCCHFBMBRFfHMMMCHHFBMBbbHBRMCfCSfffM#
#bHSBCMMMSRFMSMCSHFCHBHMCCfbFFHCFMBCHFbRCbSMBHSSFRMfbfHFbCHbbHBfRMMHSbHfbSbbHbHHBHHRfMSFHbSMfbSbFSC#
#BFRBHbCbHbSfCMBRSSfMRCffCbHRHHFMMSFfRfHCCSfSbffRSHbfbbMbfSFBfFfMHFSMRMbRSHSMBBFMRMCCMHFRMBBFMMbSBb#
#HHBbHMRfBRSFFbbCSbCCFfMfBfFSbCbBSfHRMbMRCbMffbfCbCBbbSBBHfMCCCCfBbSHbbRCbfMMCMBRbSMHFFRFBCMHSFFCCf#
#SfRbRCBMBRRbRSHbHffSBfbRRbMbRSHCHSMRbFMMBMfbffRfbCbfCMHMMSfFCfCbSFSSfCCfMSFSBbfHFBBCbHSFRfCBCRBMSH#
#SBbBMBSSMfRbFbCRBFMBCFBfbSbCMHRbSBbSbSSBFbBMBCFBRfRFBHHbCBRRFSfFbMfbCCFfMbRHBbfMCRMMFMfSbHRbbCRfSH#
#RMSRBMfMffBBbSFRSFRRMHBSfMSbBFFRHMbRFHBBSSMffHRMCSBRHCHbRbSBBfBRBbBbCMbbMHCbFbRfHCMBCCSfCSMFbHCBfb#
#FHMfSfRSfbbBfbRSSffBBFCRfBSbffBfSbSFfBMSHRSCfCFMbSFHbSSFMfSBMRSfBRBbRCFFSSBCfFfMCfRbMMbSbSBbbBBFSC#
#RMSMFBFFHSHHMRFfRFSfFCCRSSRCFBHbbRFBMMSMHSfHHfFHMBfSRMCMSRRMfbffbfFBbfRMHRfHCMFbMfSCMfbBCBbFBfFMSC#
#MRfbMCSSSRSHbfHFFCBRbbCCHbHFBHfHSRfffBfHCRfCfSRbbbFBCHBBCSSFMRMFMbFCRfSfMCSSbfCRSCFbRfBfSFMBFBHHCS#
#bMBRSbCCBMMCfHCRRbSfFCBCMSbfBHHfCMSCRfMRFFFRHSBRBFbSRSHCMbSbfBFHCRFbFHFSMMFHFSSbfbBRCCRbSMFRfHBbHf#
#BBBMSFSHCSCSfRSHSSbFFMCMbbFBbHHFBbBSMFSHfSBMBRbBbFMCbbMCBCbbBCFSbMCMBbMBMfBFHMFHRSSCfHFCfSCfRFRCBR#
#CfFMbSBRfbFMfCRHFRBMHBMfHBCSCbRCfbCBBbMffHFSRSRMHFRMCfHffRSFFFMBHbBSCfHMCRMbfBFBSCfCbRCHMbfBSRfCfC#
#MRBFSMRSMfSFSBSSCCFSBHMfSfBbRBBRbRbBBFHSMSBBHfFHfbRfbfMSHHRCbBCMCMSRMSRfCFHCFRHRHHbMMfCFRFBbBbHFRF#
#HRSMRSCMCFCMRHRHHSHfSMCfSMBbFSBHBHSCSBCBSHSFSHBCHFHHRSSbRHfCbCFbSBRRfRbFCfRBCSHfCMBCBSbfbHMRMMHCHB#
#SHfCSSbbCCSbbHSRMCSMfHCCbMMffffSbSCRFMRMfRbRMbfCCSFRCBMBRRCHMRMRRRRBRfbSbbCRSHCfCFSMSbCBHBbBMFMRSR#
#fSFSSSFHfbRBBFSHCSFCFRFbBCHfSSfbBCfFFFfSFbHSCCbSSCCSBCfbbMHHFFCMbCRHBFFFCBHbCFHSHFBMBRbMCRHFCCbBfR#
#RCFbfRFCHCFRRFMMfHSBfRSFHFCBSRBCBBHfMFHfMBBMFMbBRRFSfRSbHHbCHHMbFHFFSFSfRbSMMFBCBFMMHRHSCHfFCBBCCC#
#HFRHMfSSbRCCCbFBSbRfMRfMMbRBSbBbbbRCRMffFSfCMMFFbMSMSFSCMSHFHRbffSFfffRHMCBfMBHCMfRMMSBRFSRfHffffC#
#BCfFfFHMSSSCFRRMCHfBCbbfHfSMfFSMfBHRfRRBRRbFFbHSBHSCbSbHBSbfRSHSSCbBfFMbFHMMMbCRHBBRRbbMMFfMfHHFRF#
#bSFFFSRRRRRCMBSMfBHCffHbMRHRRRbFSCHSFSbHfFfBMMRSfbHHMRffbHbBRSCMFMbBbCMfCMRRfMSRCSffRBRRbSHBbFRRCS#
#FMFCFCRBSSRFHFHFMHHRBBMBHHSHCHbCRBfbBRBSCbRHBCHfRBfMBFCCfFbMffBFRHCSRCBFFSFRBHHSRMSbMHbbfBBfRSSbCR#
#RBbBHRfCSHfFFHSSBSCRfMFfHCFFFMbSSfCMFfRbCSBfFffBBRBFRSbMRMRfHFHfBCFFbCCSFMHFBSMRSCFfCCHCHHHHbSSHSR#
#FSfSSBHfRMfSRFFHHSRCSFRBfFbbCCRbMBCSFCBSHfbffBSBRSfFMRHCRRHFCMbSSMRHbCBFbRSCMCRSfMCfMfSHffCRCCMCMC#
#RBMfSHHMHRMMMFRMFFCHFSFHMRRMCHCCRSfMHBbBRbfFMfMFCBCSMBFMRFMbBFBHSbfFHRRfHHHHFfCBBMFbRSSBCSFBMSbCCF#
#RfBBHbMfFRRSHSCBfBSBfbHMbMRHFCHbMHBHSSHSHBRfbfRbfRCRHBMHfMfHMHfSbHRFMRMBBCCfCMHSMRBMMMHSHRHHfRRRFS#
#HSSHbHfMCRCBCbSBHHFBMFRCBFMRBRFRBbMbRHBMFffRfRCHMSFRFMMbBFSfSHFbbfFRfbRCbHRCRHBRFfbBMBFFMbSFbBFFSf#
#BHfFHfBbCHMFFFMCbRfRbMBFSSMMBRRbbRRCBFBBSfRSMCbRSbfRSRMbCFbBHRSHfbFRRCfFfBfHSbRSbHCbSBHSfCRSHRRbBC#
#HFMHffBSSBFRMSMfHCBfFCMSfFSBRMCffRbSCSSSCCfCMBRSHHRRCSfHBBffRfbCSFffRCbfHRSbCBFRSRCBBMMCbHCbfRMSbC#
#BbfRbMCSMFbFSSCbSCbFBSFCbRfFHFRFFFfBbMbRBfbBfbffBRFfSCCBMMHBBfbHMHbBBHRFCRRBRSfHSBbRBfMbBbCSFbMHFS#
#SRHMFMfMFRfbBFFHHfSFfMbFHCfHFFHSRBRCMbMCCbCMMCBMbbSRRHFfBRCSFSCfffHFCfBfSbSSSCRHbfHMRbCRbRCMRRHCSC#
#HFRRfBfbRFHfRBCCFbRHRbbRMMbMCSbMFRFMBMFbfCfbMMbCCSSCMRBffHbFfHMSFbBHBBMFFbfMRBFCSMbfbHFCfSHFBCMFCS#
#MbCFbMfBfRfCCBHCFfBSFHbBMbBHSRCfMbCCFFMHCBMbCRHCbbbCSbCRSbMfbfHBfHHMMRMFHCMfbbBHHSFfRBFRRHBRSSCRBM#
#SffBCbCRHMbCHFFSMFHRSCCFCSCSHfCHCFBBbBBBCRbFFRMRCSRbFCfSFbbCbffSRRMRbfSHbFBfMRBHBHfRHffCHbSMFHbRRR#
#FfFMSSbbbHFCSfbfCBffHFCSSfCFbFMRMbCSBfSRfCMCFRSSFbfBBbSRMMbfSSSbffCCHRfRBCHSHBffSfbFSMHMSfHHMCHRHf#
#BRbHBbRHBBHSbRMMHCRSbMMFRRfFfRMRbMBMHMRMFfFCFfBMfSfCHRfHMMbHfHfbffRBCRSbCbCMSMRfFFBbSHHMCBMRSbSBRS#
#MMFFMbRfHBbFFMCBfBBMfFMHSRfSCCfFHCMMFHRFSfHbCMBBCFBBMMBHMCSbfBBCCFHBRRbMCCFCRFfSBSMCCMCSbHCbCFFHfH#
#HBSHBbFHfMbfMfRfRbSbFbBffRfRfMRbfFCHMRRCSFCSSHCMMHHfSCHMHFBBRfbFBFFMCSSfMSfRfSfMSBfMCffSfbMRBbbHFH#
#fSCRHFbRSRCRBBSRSbMbHSMCBRHRCbHHMBBBfSCMfHMSFRCFSCCSbRRBRbbBSfbCbbBRBMbbRSCSRMfRMFCSCfCSHfHRMMSFFR#
#MBSBFFFHSCbCRRRHFSMBFFFFFffSHCMCCSRfCbCFMBFMCCMbbBRCFHHSMfCbRFCfCHbCBSCBCCbBfHfHSfFFMMFFHRbfMbFHCM#
#BHRFfHCBBSfSMHMCbFCHfHffCSRHSHbFSRBMHfSbRbMbbSSSMMfMfBRHSCSHRCCCBSCMBbSSfFMBFbRFCRFHSFRBFbRHMbCFSR#
#BfRRCFffSFfHBFfRHBMSRSRHFFfffFfSRRbRbMRbMSbFCBBHMBFbFHCFffBHRMRMCRHbbCCBMfBfRCCMSCRMRSFHFfHFbMHRMf#
#BbfCbBbfBbFbFCHfFRBRbRSBHBSRffRHBBFbbRCbRfMfBRRFRFHSFMbSbRSCBSCFCfbCCffMCfbbbHMRfSCMbHfRMSSMRbRCHR#
#HCRBCFMHFSCRRFSfFBFBFSHCCBHRCbbMSHSCHMBCfCCFRBSCffbSfRCFRSCfCFSCFCBbMRSCbBBRFHbfbFMSRHBbBffRRfMMCb#
#bFCMfSbBMCSFbfCHfFSFRBBbRCCRMCBffBCBFRBCCFMbMCHfMSFMfRHSbBMFHHRMBFRHffCCRMFfRSCRHbCHRMHRHFfFRMFBSH#
#SCMHFSFbCfbSFSRSCCFBCBFffHMfSBCRCFbBfbBfBRbCRBFMCbMSSCSRCCbMBbbSHFBSCCfCHMRHFHBRfCBMCFMMFfFCbCBCSR#
#SCMSMfFBbRMMCSMMfMHHBMFFMSfRBSFHMBFHFBRFSBCBBHHCSFfMHFBHCHCfMFfSbbHMFCfMFHSBfHfFbffMFBRFfRFSCMHSHC#
#FCBRCbCFbHCRRbHSfMMMHRCfSRbRBbMfCMCbbMCSBHFHHBHFMFMMbBRFBBSfMFBSCHfFSfMHRbRRfRfSbfSFRFFbbMfBbbFMbB#
#FFfMCCMbBHbMCCFSfHFHFMCfSSbBCbSfCBCBHMfMfCBBMRFCbRSHfCRHHfbSFbMBCbMFMMbfSMSMBRRHMCfbbHFSRRFSMSfSCF#
#BCMbSBBHMHHbBFMHSHBBRCRCFHbfMCMHHHbfBHCbRRRfCRSbfCSMHBMRFFMHSSCBMMHFBMfRSBMBHHfFRfSCMHSffRSbMBffbB#
####################################################################################################
