####################################################################################################
#BBffffCHFBBHBHfRRMSBBRCfHfBSMHRCfBffCMSMHMFFSbBHbfFSMfFFCCHSFfSRSbbBfSfFMHHbHCMRbCMMbSbBFSfSfCSSMM#
#BRFMbSRHCMHHFSBfBSRbSCMbRBHRMHHSCCFRFBbCMFfbfFfbbBSfbFCHFCRbHbCCbMfFSSBbRBHBFbRHFBFMBSCMbFRFRSbBBR#
#SbSBbCBRCSSCSbCCffRfSMfMBFBFCMfBFMbHRRCfRBfCMfCbbfCBCCFHCSHBCffMbCMSBFBfbRBHBCbbBMMfBHRbCFfFRBMbHB#
#fCMCbRRFHbMFfCHFMfFRHBfHFSFCHRbbBBSCBMbSRBbbBBHMCbBMfFfbfRRMffSSFBSbFMMCbfSMbfMHHBbBCRfMbFbRbFCSCS#
#CHCHSRfMbRBCffSRHBCbFRSHfBbCBRSCCMHHFSHfCSfFCFfRbfMBSRSRbbSHRMRfMCbCHfMfSBCFBbCBHSRRCbCbMRCfHHCBHb#
#HbbbBFCSFCBBMRHSSCbSffMbBSBbFfbMSRCBbCBbRFSfBfRRCHffRRfCCCCfFHffRbMMFHBHBfCCRBFSbfHMfCSfBFBFCFCbRb#
#CfSCCSFHMfBRCffbBMbBSfBRBHBbfBBfbFMSSbbSMHbCfMRfHMCFSMBHCBCRMBHFbfCBRRffCCRCMFHRRMHfMRHbMFMMRBSfRM#
#SHbSRSHbCfRMMbRfBHBFFMbfCHSBHMCBCbbFFFCBFCbfBfBHfSbRSMRMRffSfRfBRRMSMMSMRbSbFFBBbbfBFCSCRMCMSHRFRF#
#SMbfBbbbRBSbSbFfHBbbFSHRMMHbSfRCHFRMfBMCBfFRRFCfFFHFFfCHCfBCSBRFFHbHRCbRHMRFbFHMHFHRbRRBfbRBHCRFbH#
#fCFMRBCRRMRCCRHHMbRfRFbRFCbRFHBBCBfHFfRFSffHCMfMSBCMBRMRBRMRHbRCFSRRBfBfFfBRHbFfRfFMSfBBBCbbbBSCfb#
#fFFCbSCMMFHfSMfHHBfBHRRbHfbfCfMHCHFfMbFSfMbbHfSBBMMCMFHbRMfHHSBRBFCCMRRCRHBbRCMFSRMMMRMFCHbRfRFSRb#
#MFRHMBfMFSRRbBbSSfSCHfRbSSFCRCfMSHFRfMSSHCMRBSMSMbfCCRfSMCHBHRRMCCMSRMfCfMCbBFHMBHSbRbHCHHCMFRMCSS#
#BSHfFBSSRHSHRSMFFMfbCHBCRMSHHBRfSHSFSRfCbRMBCCfCCSFMHbCbMBCCFRRbSSHRCCFHMCFBRRCbMffbffSCbMMbMFRMMM#
#CSFRSRMFRHRHBCbSHRCbSHbBCCRSfMSFCBRBHbMHbBBbHSFCMCCMCRCMFMRFBbMfMSBHMHBBMCCRMbMSCCSFfHFMMfFfbSSbbF#
#FbRBbMfCRfRCFCMFCCFMfFRFBBbRBHMfMBRfMCFfFSBBRbRCfFFMbBBBFRSMbHBMFBFSHbFFRSMHFbfRHRSMSHSfBfbHFMHCBf#
#CHCfSBMBfHSMBbfSFRFRfRbSBCRfbfFHMMbMMBMCMRbHSbSbMCMbCRRfSHSHBbRSMRBfMRMfRHfbMbfSFBCFMMfRSFfFMSbFMF#
#RCbRHfBfMHfHHCSFFBRHMbSfMCHRRBfBBRRfBSfBMHBfMfHFbBCCfSbCbfSSHHHBBbSHRfbRSSSHSffMHbBbBbFbCHRHFSbMbF#
#MfRFbCCRRbMFMBBBRRRMFSHBBfRSCHFBRRbbRCRRCRSRRMSRBSMfCFfFSBBHbHBCMSbCbCfMBFbMbfBMfHbSMFSCbfbSHMbSfR#
#bCHbSCHRbCSRMBRSSRCMBSHCBRBCbfRCHRSSfMffCRSBRBSbFfbSbMFffbHRSMbHFHHffHHBfBBCfRHBfCCMSbSFfRMSFbfbSF#
#MbBCSRRfCCbBSffCfbFRfMCbSMffbMBFFCfCbMMfFCSMHMMFCSbSHHHRFRSfFbFHbMbCFRHHbFSCSBFCMFSCMfFCFFbCSCbRbf#
#SBSfBBSMRCCFCbffRHMbFHbFCHBRFFbHbMBFFfCfMRFfHCSbSfBHbHFFbCMHFMBfRMMfBBFBBBMFRCBBMSSCCCCSBSfHSHffCR#
#MMCCFBRbRfbBMBHRFBHMHMCFSCfMBMSCffbSRBRHBMbSCRHCRRCHbRfFbFRHMRBSBCBfBMMFFbMFBRSFRfBSBHFHRbHBMHRSHM#
#RfMHBRFRRRBffbBFffBCbMBRSRCBfRHHMRHbMbBfMMbFHRfHRMBSbMMSbFFSbfSRRHHMHFCMSMSMRCRSSRCFSHbFSbRFHFfRCS#
#BFbRSMSRCbFfCMSRBbffBBfHHCFMBbRBfSMSbfHBMFRSSMFFMfCHfRfRHbbRFMffMCBHMRHbRRRfCHCRHBSbMSCbCCMHHCHHBM#
#HfHCbfHHSCCHMMHFbRSMBMMHMbfMRfbfbCFfFbFFbMRFFBFSHRBSHBBMfRSbbbFbFBFBbHfFSSBbBFSbBMffMMCFRbBHRSFfRC#
#HSbfFMMSSMBHHMHFFBMSMHfSMSFSFCRSBFHBMMbCMSCMBBFHbCSRBfFBFMSBMMRFHRFCSFRfFBfHFBCbSMfMRbRHMSMFFbbbFB#
#CCSMfbSfCfBfMSCbMbSBHMCRRHSBBbFCFBMCbFbMfFBMBBfRHHCCCBbCMBRBbBMMSRRFffbFCCMHbbFSBFbHSCFCffCSSMHFBM#
#FBMCSHFBFSbBSFCSFSSHHCbFCFMHBMHbRfMFHbMSBMRMRSSbCMMHHbbHMMBFMfbMMBFBRSMHBFbbRSHFfFBfRCbBBBBHHRRMRC#
#MMCRCSMCBHSfSRSCHFfMRRBfSBMfbRSMfMMbRMHHHMbHBCCfCRHbBbFSSbRbRMCSMHbHHHCBbBFRRSbBBBbBMFBHBfCMMHCCbR#
#RMbHfRfRFHHFMMFSBRRRSRMCRBfRBFFFfBRbBHBfFbHCfHBfbRfHCFMSHCbFCRfRfHHMBFCHMRMFBMCfCRRMRSHRfbHFCCFSHM#
#BRBbfBHfCRbSHMCbMHBbHHHfbfFFFMRRCMFCMRfMbHCRCSfHRCCbMBHSMfRSbCFfFSSSSFFRCFbfFbBBCHFRMFfFRSHHbBCSFB#
#HCCCRFMRfHBCCffSRSSMRFCHfBFCfRMMBCBfFMHMCFBfbSBbbMbFCFfBbFMRSfBSbBBBbCBCfFCBFfRbfFRffHMFHRSRMFCFfF#
#CfbSSSCHCbSbCBMBbMSCfSFBHBCCBHFCHHCSBFBbSfRbMbbbbbFfRCBSfCMBfSfCfRMHMFBBFRHRSRbMbMHSSCHSbbHRHRCbBf#
#HBCfBSFSbBRHSCbCMCbbCfRCHbbFBBfHbSHfSRBMfMHRBRHbMfRCRFRCFMMMBHRSbBCCHRSFSbfBFHbCHHRMHRFHSMSCfRMfBS#
#BfSbBCMFFBFBfMFBBMBfCCBFFbfHMfHCBbbCFfbFSRfFSBMFCBbHbBRHMFSbHHRFfHBfMHCHHBRMRHSFHBMCFRSBCMHFMSfHRf#
#FRSBCMRFMHbMBBFHSMBRBSFMCCbfMHfBRBFSMRfMMMHHbbCFFCfHSbFFbfHbRBRHRBbRFMfMCFfFSSbCBCHMSBRFCMMbHBfHRH#
#HBHfRbffSffHRMfHCFHMFfSbfRbHCSCSBSCCSCfCbSCfCRFSMMBBbffbRbFMBfRSMRCFMBSCHbCfSBFfSBbBCBMFRHHRbRbSFH#
#MRSMSRbbCRBSfRCMMbFbRMfRMRCBCCCHCbCMHFRbfFMRfBfCFfMBSRSfbRHbRRFfRHHBRRRFFMbfRSMMfFMCBFMBHBHCBHbSSR#
#MRFBCSMCMSRBRSMbSSHbSFSRFRCCRCRFFfHMBMCBCHHHHRBBSfbSHbbBHfBFHCRbCFMRCHFRHbCbSFFfMMMbFCRCMMbbBFBMCf#
#fRSMffbFHMRCBfHHCRBCRRCbBBFbSfRCbMfMCSHSfFMCBbffMRMbbCMMBSBHMHFbMHMRSSSCHCbMSHMCCfMMSSbbbfHbRFbfSS#
#HRHMRRHbMCCRSMBBbfBCSSFbMMBFHBHCFBbRfMfbSfHBfHRfSSRSBSMMHSHHRSSfCFffHHMMSfCCbbRfFCMfRSMfCHSbHfBMSS#
#bBCfBfSHHFHbfSSBMMHfFfHRbffSfFRbCSCfSSHMBSfHMBRRbCRMCfbFfBBBCbfBRfBRMMFRbMbHBCHMSRfBbCbBfSfbfbMHMS#
#bHFRfbCSfBSBRFbHHbRRCbHFMRSFMbMfSfFSBbCCMbSbBbRHCbBfHCHFfBbbHCBfHHBSMBSfMfbRbRRFCffRCRHFMSFRBHMMFH#
#SRHBHBHfFHfBbHMSfSBSMMbFCMHfHbRfbSMSFCfBfCBFHSRBRMFHMHBRBBMRCBCHRBRHbSRCBMHFbBRbbMbSMfSbRBfRHbFHRR#
#RfMbbRFSRfHCFMBbfBBBBfCCbfFRFFbCbbCHfHbBbSCBBHMCfFRHfSffCfSSSbSHCRbRCRCbbMMFfHffBMSHHRbSBRFSBRffbH#
#bbMHHHbRSRBbBbHCHMfRBMFfBCfBRRCBHSBMMBBHFSbBHCRfCRfbbfFCfBRMbffRHMCRHCRMSSMHSHRFFbHFMbHFCSbCSbbfFB#
#SMMFHBBBCMbFBCMSFRMBCfHFSMBbbHbHSfHHBFfFBMFbRMFMRMbRBBHBbFCbRHMbRbbCRbRCbCBBHFfHfSBbHHFFRSMSFRbBfR#
#SbbSFbBHBfSCBBFSbMbHHSFMHBHHFHRHbCFFffbCSbFMfHMHFFFHBFBFbfSfHSRCCffSbSffBFMCRBFBffbCMHCSBfRFHFRffB#
#BBRCMFFMCCFFSHHBSRHCSBCMRBMFRbMSbfHFfMRfMBHfMCFSRBMfMRHbMHCHSbCBRSRbBCMfCbSHCbBHSHCCCHFbMFRHHSfHFf#
#fCMbCRbSCSRFffHHRBbbHSRRfMSBCRMbSCMBSCSffFRbCHCBMMffMBCCbHHMSBBRSCRBbfFfBRMSCfSFfSFSCFFfFFCBCRBRCH#
#HbFHbHRHBBBRCRHCSBRRRHHfBbRbBCFRffSbSRRSFRMCHSCSBRHMHSFCFBBBfRSHfCFHfFSRHFSCMbfCCFfMSCbCbMHCFSBFHH#
#BfbSMHMCSFCCHCbbFHRHfBSFbFRHBHRRBBRbHBRSBSRHHHBfCMbBHBMCBSfSbbSFCSBMFCCbMBCbfCFFFbSCCbSSSBCCRbCBfR#
#MSBSFCBBFbfRHFHbRRSCFFHMBBCbHFFFFfSbHMbRfCBBCSHRHBbbMCSHFHBSHfCfBHHCRHFHHHSMSFCSBSCBbRMRBRHfRbBbBf#
#ffHRRFFMSRBbRfCFfHfSSMfSSMSRbHCfMSCFHFfBbFbBFMMBMBSSCRMRfFSFFFFbbBMCffSHFHSMSBbHFRRRHRMFBBFCCCbCBH#
#bCMbCfCRHfCbHBbFSCCMBfHFBBBBFHMbRHFbfBbbbCffbfFfCRBSCfRHSSRRSSCMCMMSbFSbFHFCFBHBRFFbCHMMHFSfRHFbMf#
#FMBCHHSfFSBRSbfbbSRHMBBSbMBRHHfMCFBRHBRFfCCfMBbRSfFfRBMMHFBRbRbSfMCCMSBHCSSfMHfRfBfHBBBSHbRMfbCSMR#
#fFbCMMMMbbfbbbbHSMFHSSMHCfMCFCCSfSCHCbFfCbbRSMSBffHBCfCRfbCRRHMMBfbfCFRbBbfCbffBHFfFbBMBFFRSMbHFCM#
#CCSRSCRSMCHMBfbfHFbSBfHRbCCbbHHFfRfBHfRffBHMMbHfbbCFHSBMCHHCbFRfCfbCBbCBHfSMRHCBHbRfFfMHRFCCSBbMSH#
#fbfCBbRSffSSRRRCMBHffCBFRCHbfSSbHFFHSCCCCbSHfBBfBCRSRFbFfMCMCHbMfBCCHRSFSCRRbHFbRbbSHFBMSMRfRCRfCC#
#CFCfHMHCRFMCBbfBFRfBfHCbRMSFbFSfSHfbRCbbRFRMCbCbRRSMBCHfFBSHHHRFHRMHRBSFMMSSfMbMbSbBFCMFfHfCCCCbFS#
#SFFMHHHMfSBMbFfHMMfCMfMCHMBMffBFMFMMCbMfSSHHFfHFbRfSCRMHRRFHSHHFHRHFHSRCFfHbFMBbHMRCBbbRCffMfRSbRb#
#bCfBRHCHHBRSffbbfBFRBMMBfbCCCBBMCbCRMMBfBCBHHCBMRCBHHCHBHCHRRCbCffbfFfMFFMBfFMfRfBHFCfFFCSCRCMSfSb#
#ffbCHHHFSMSRRbSFSHBCFSCSSHSHCHSHSbHHRHbMRCMCMbHfBfRfSCRMffffBfFSMFBHMCRMRCHRfFBBMBSSbMCCHfbSMHbHFS#
#HbHHFFfRSbCRMFfCRbBFSCHSbBFHffbBMFFBBFCfRHFffMCBSMBHMbFSMCRMSbCFFFMCSbRSfMbCRSRMbfHSMRMHRHHBFCfBHC#
#fBBFbFCCHHMCfBMMfMHMfFSHfRBHfbBfMHRCSHRMFMMBHbRSSBFSMBCFfMSBCCfBCCFfBMCbRffbMHMCFRBSCCBHSHBMCfMfHF#
#FHfbCFSfbMfCMSSMBfbBHMSHfSHHRSbBfSFMBCbFSHMRMFbFRbBbFSMCMMCSMBfFfCMHRCRFHSCbfCCCfCSSSCbBFFHSfHRFfS#
#RSSFfMfFMBBfHFbRbHfSMbbBHBCBbFbbMRRBfSFfffCFbRfSBMfSfCMfRMfbCMBbBSCBRFfCFHMbHHFMfHCMBBHRBfSHHMfRfF#
#FCfSfMRSFSMCFbCHfbFFHMHMMfbMbSFbCBBCRFRbRbHFMbCHSfFMRMMHSFfFBRfCBHFMFHFBBCSfBfCBSfbFSFBHHHCFbfFBSR#
#fCBRSMHBCRCHfRBMCCFSbFCSFFSHMMFCFSbMfFMfbHCFSBfRMSRBbFHfMSCbBHbCHMMfffHHFfMMSbfHCMCRbMHbMBfHCBSHHR#
#bFHRMCfBbCbCSSCFCMMHSbRFRbSFBSBfbFRbCRbbMSbbbHfBMMBRbRbRMHRMFRHfCMBRFHRHFMbbCMFbHRRSHBBBSSRRFbHCfM#
#FbBMFHMRbSHFbSCBCBCbbFHMBMMMCbBHRRCSSHRSbbRbfSbRCMBfHCSffHRRCfCBBHHCFMBHBFfFSfCCHCRHCRCRMBHfRMMfCM#
#RRbCHMBMHfSfCCfRSHCSRbfFCSSfHSfbBSBSRFRHMFSBCfCMfSFRFHFRMMCbSFSHRfbHfSFMBMRFSSFbSRSCBCMRSRCfRbFFBB#
#fbHRCMbFBCFfCMbbHRfHbFFbHSbMFCBSMFbCfMSMCFRSCfHSHCSHBbSFMCfRSHSBFBbBCHffCFFMBMCHSRfFHHHRMMMCBBRfMC#
#CbfBCfffbCFRRFCRfMBRbfBFCfHSbCCHHfbBfSHBSCfFRMSCHbMFSbBCBSRHBSSbCSFHBBBfBFHBSRfRbRMCBSFMbRHFRMSfMR#
#fHRMFbRbCFFfbRfCbRbbfRRBBBFSRRFBSRCHbCbBHRBffRfRMbCCbbBCCBCbBFSBRfSbFSRCfBBbbBSFfMBbRMfbRMFfHCBFff#
#MHSHFfSHRCHBbFHFBBSbHMbBCfHRCCMMSRCSbHRBbMbCBHSMSHBHCSBfFSbbBBFSbFBRRHBFFfffbSFBffFBFMfFbCbSRbFfRS#
#MSfFHMSFMFSRHRHfSBFMHRRMFCBbSbBFHFfSRHMRMfHbCCMFMfMBHSCHHHbSbHMRBSBCfRSfBSbMSfFBHFRSbbfSBMSHCRbbCS#
#BRRfBMSMfMfHHRMHfRMHMFBRRFBRBCHHHRHMCMRSSHBMSMMHfMMSMfRMbfHbBFCbRRHFHbSHSBBHRbfCSMHHMFfHFHBRFbSFSf#
#SMCHFBffbMRMBCCHbRHFfMHBSBRbRBbBCHBBbCSBbFMHHHFBbSbfCBHBbbSRMfHCFCRFFfbSRHBCMbCBCFSfbbfSbHBfRRbSBf#
#fCSCbHBCfCCBbbRRbHBFbffSSMbMCfFRHSSMRHSCbBHRCfMHSbfHSRCRFMFRSRRBMbMfFbCSffMRbRSRMBbFHFFHCfSHRBCRfF#
#CFHRMBCSfSfFBFFMCHbbfCHBMRBBbHFFFHBCFFfCMCSHffCRBHMfBHHCBfCFSBbfSRfHSFMfCSHHCFbSHCFCfCSbHMFMHfMSBC#
#SRbbFCSSHfHCBMMbSbBSfFCBSfFSfRBHHSCbBRRCFCfFRSRSfRfRMFRbfHCFFFSMMHbfFfMBMFCBRFSfRCfBFbCFHHHBBHHfRH#
#CFRHbbfCSBRfSCBCHMCBSRbMFHfRMMRfFMHFHRRHHfSFFBfffBHfCCHSRfFfHFMMfRfMFMSHMRBFSHSCBSRFSCSMFHBRbFSRfF#
#FbMbRMbRBCRFBFFCBFCSSFfffbffFFFCHMBMMSbbFSMbbSbfbHCfCRMMRCbCFHBFSMCfbbHRCCCfBRSSFRSFHRFfRCCRSBSHFS#
#CSRFBfBFRCfRHHRMCffHCCFMFFbbCBSHHHSMMbFSBMRRBCBBBRMRBbfCCHbCbRMHfFCRSMRCfFBSHRHHCffHfMHHbHHCHbFCFM#
#CbRMMHFBMHMBSfCHbCFCFbfbRfbfBHFFCpMSbCCbBFBMfSBHRRFRCBSbRMBBSSSbCbRSSbCffHCSbCCFbMRBHBHfFfRfFBCBbH#
#FHSMbRBFbHfSfHMCfCHbFfMBfffFfBRSBFbRHbSRRSfCCbHHCSSFBbBRbCCffFMMRBSCHSFHMfMBfSMBSHRbbHSMBSHMHRFHMS#
#MbSRbHSSRCfRCfBMffCCMfCCbCHCbCRSfCbRRMCCBRSMCSMHbSMMfBBCbHBRfBMBRHMfCBSHMSRSbCBMFSbHbbSBCHRMRFSCFf#
#SMCFFRSbfCBSMMbFbffbFSHCSSSFHMfFfFCBfCbfFfBfRBSCbHRFfCRbfHMbHSfSRfCfHFbMFRSBRFHbHSSBHFbHBBFCMbfFFB#
#RMBSMMHfSffRSSCMCRbHBSFHBHRHRRbSRfBRMSSMMSSBHSSBSFSCSFBHbMHbRBBfSbHFSBFCCRFCHBSCHHfSRMfRRFBHBfbBRS#
#BMHFSMBBfHbCMFFCHSbfRCCMfffBfBBRRFFbCHHBFSRFSFHHBMbSSFCCfSRMBBbFMMFffSRbRSbfSRSFRMHMHBbBBfbCbbBMSB#
#HCHHbfHMBbMBbBFHCfBbfRRbBFfFRBbFRbMBfMHCfFMBfCBMSSSCRRfCbHRfBRBFHSFBFSSfRfFFfCBRbCSfBbHfFFSMCfbfFC#
#RBbBHBMRHbFCbRMFbBbMbFCHfMfFRRHCBRBMMfRHRFBHSBRSCffMfBRHMfFbCHbBHCfCCfbRMfHMHCFBBbbBbHfCFFHCHMfRCM#
#HbCRMCFfbCbBRBRFHMMRRHBRbbfHBMMRbHBBHCbCBHHMBbFRbbHRbHMFSCRFFRRMHHbCfFfCSCFRbCFbMHCbRSFMFfHSRHMBfM#
#HCfRfRbSfFMCSHCMSHMHBbSMBSSMMfMCbbBMRSFbffbHfSMSBFbFBCCHHBbFSFHCRMRHRRMSFFFCSRfCSHBMSSRRMCMMBHFMFS#
#BMfHbCFCRMfMRBHbFbRCCBBMSBFMHCBHMFSSfBFHBSMHFbFCSSfCFMMHbSRSbRBBBHSBbMHBCCHFMHHRHbRSfMRRbBCbBRMHCF#
#CRfCSHBRBFCCFbRHHbSMFFMBBFMfBfbHBBMRMHMMFffMbHCMfSBfRHCCMHRFffbCbSMHSMFCMRbCbbRBRfMBMbbRHRRRSBCbMb#
#fCRfFSFHSFFbSRCMHMffbbCHFbCSRfBBFHHBCCRCFbCHbSMRFFFBfSHMRMbMCBSBbFbbMSfRRBMMbbfBbHRHFHBRMbHfFFHMRM#
####################################################################################################
