####################################################################################################
#SCSCCVfbBMCRbCfSRMCMHSFfRHCffBVSRBVbBFFCFRSCVfFCFMMCHCfCfHSVCFfCCCBMBSSBBRbVVRRffCRbCMSMCHSRRVFbHC#
#FCfVRfFCbMCHHCHFbHMFHMSbMVbBRMRbbHRfVRCFRVCHSbRHCSVVbRbFSRFMRbRRHHHRSVSMBCCVRBVSSBfHbFFBbMHRCFRSHH#
#RBfbCCfVFbHBBVVVMRBHHfHVCfSbHRBCVFbHRFbBVRfMSSBFbVfVHSFCMVHVMMMFMSbfHRSFVCRHSRHFMRHBFRSHHfSSMHSFRR#
#bSCbHFSRRRRHMffCBRBBCBHMSVFfRCBRBCfCSbHVbCRSBMRbbBBVbfMfBCbbFHHbfRMSfMFfVMCCBHHBRbVfSFfVfFVHHVRMbB#
#fBRBMCfMffCFMMBfFHBBfRCbFHVfVHBMSMHSbCHRFHBHBfRMRSfHfRHfSCFRSMFSbVfMSbbRCfbSSVBVFbBVMCBRfbSBVCbMbb#
#MRFFCHHbbSCFSCMMCVbBVHVbHVSCffRVVCfVSFfHSVCCRfVFBSRbBCfFHbBBRbVbSRbMRFCSVSfSSfRbVRRCSCSffBSRffCFfH#
#HBHfMMVHVCRbbSFFSSVHBbBVfVHFHVCfFFSbMCCbCHCbBVCCVCFRCRMMfBHSSBFbVCBSBVBbHMMbHCMfCSHHHFCFRHfFMfVRCS#
#CbBbbHSbFSfFSVHVRRSVRbRMRSfCbfFVbbHfRbVFVVVMHbfCVMVBBHSFHRbCRbRVFVFBCHHVCHSHRCbBbFHFbfbfMFVfCBMBVC#
#RSRbCfHfbVFfFSBVMHfBVfBSMCMBVfHMbSRRRHHFMHFFRFRVBMfFbfSbSCBMBFBRFFBRFRSFMSBMBSCVfSCBCfbVHRHCbbHHMC#
#SRBbBSRSVbRfFbHFfBHVSfBVRSVBSCbHbFRVMFfCHHRMVfCFFHfffSHbSHVHCFHHfCBBMBfFSSbHVHBHCbBMMbfbSfFFBRHbVV#
#bHSCFSfSMRCHRRMCbfVfCFFVBHMHCCFRSHRFbHVMbMfRVCRMMVRSfFVVHfRMCBVRbfFHVVBMFVFBMMBHBRVMMHHFbCHRCbffSH#
#CCSHRSMffHHFbCCFCFfbffCfVbMRVSHHfMSfFCBVRHHFBBfbFFRHSHVVRbRSHHVFFbMCRFCVFHRSfbMfCFBCCVMBVBFCVRVSMB#
#CFfffCfMHCVHHFBFbVMHRbHMCVfbBRSBbSRMFFSBfHfCCSCRSBSBFMRbVbVbFfSVCBHHbBVffRfHVRBHSBfbMHMRCMRBCSbCfV#
#MSFFVHfCFRVRRBMFHMFMCSFSRFSVMRFRFRRBCCFHSMVCRHFRbCbSFCRfHBFVbMCfHVBCHSBfSBRBbRffMCVMSRBbFfSMMBRVFf#
#VFfMVfbffSHCSbCbHCCCSSRVSfHRRRfSSHMfRSHMCBVFRHCRVBVVbRbfRRbRMHBRSHbBMBSCHCMCVCCMFHFbSCRfBMRBMHVbbF#
#fCRHVRbSVCRSSbSVVCFHbfHVCCMVFbMSbVCVCBMCFCHbbCMVHHbMCVVFfCCfHRRRfMSbVRBFCMMCbMfRCbMRRRVRFfMbFCSRCH#
#ffbSHbHRVSMBCHRMRBCfBfMCfRFCMFMSCRMMBBbSVRfBVHHBHRbBHMSHHFSBHMMbbVSMMRRSCVVRMSVBMSMFMSBBFVfCfMCHHf#
#fVCFFFHFBCfVbSbMCMFFMSbMFBCMHBFbbbfbbfMHHSBFBFBfSMMHfbSfCMfMHFFVRfFCSFSFbSfRHbFMCVbHVRbBbCSbbHRRRR#
#bRCFCFFFFBfBbVFHMBMFffCFFCfbSSbbbfVFbSVffHRHfRVHfVfSFRffVCSfCfHCCbBbbCbfbFRFCRVbSbMHFRfSSSBMfFfBBF#
#RRVSHSVRbBRFCSCRMBSVFBffCVMCBbfHVffFHVVSSBVMMHBBCRVSSVfbFMfbBFFBFHVfSbSVMSfSRCCMHBHMHHRFbCMHHbVFHR#
#RCRRbBMRfRMCHfSBHbVVSMfMbRBVBHCCFRSCSCbRBCFMHRRSfSCFSBbMVCBCHFbRHHBHVCVCCMfHbCVRbRCSFFbVffSCBHbVVH#
#bHFbfHMbBMBSbSMRbbbMHMBRSHVMfBBHRBCHSHbHFVbVbMBCRVbVRSbVHCRRbBHRSBSFfFffSfMBbbVCFCbHVHRbBbBCFVRfSV#
#SHffMbSCbfSbRfCFbVVMBSRbfHHCfHHbRHVbBMMFVHffbFbBfVfSSBSfMBfBHFRfSMRbbHBHBSBffSFRBRbCbBCHCHbSMVBSCR#
#MbRSbCFFbVVffSRRVbVBBMfHbHRMFSFBCSBfVBHVCBSMRbffBfHSffCVRBCCSSMFCBFVBCfFCSRSCMffSfHSbMBfFfHVMfSfHH#
#BMBSMRMSRMRbfCHRbVbbSfRbVbRVHfBRRVSMCfCRFBMHCVBbRSFBSMVSbFCFMBBHSCBCfRHMFRBbHfCCfSffFfVVMHCFRRHVMC#
#bSVMfbbBHSVCMVSFCSFMFHCVSCHBMMHFFFFFHHBCBRfMFCCCbfbSVVVMMCVMBBHRMVbFCRRBBFMFHFCVbMSHHCSSVBVBCVBVHf#
#SSHMVRCVBFfMSHfHHMRVfFBBfMHbHVCCfVFMFMfRRHRFFFFSFRbCFVMBSMVFSVbHVVRVbHffMVBMHRCRHFVVCSbFBBRHSbVCbB#
#CBfVFBbSVSFSMbRfffVCCBHVMbSfMBMfbfRSRRfCMfSRfBMVCBHbBMSMCFRBHVSFBFVMCFVRSFVBVHfCSBRRCMMCVBfVBMbSRS#
#MFVCCVBFfFfSRbFBSSHHFRMRBVFBBBbFVSfFFSfbHSbVRfSfCVVbBMbHRHMFCHHHVHBbHVVFRfMVFFBbRRMMBfSFSCbFVbFFCV#
#fCSSRSHFBVffMFSHBfMFHfFSbfVSVMSBHbMMCVVBHbMBfHfCRHCSFFSfMRMfFSBSBbRHMfSHCbfSbMVBRVBFSbCMfFRSbSVfVF#
#FVCSFRCbFVBfCffHbfVCRHBFCSFMCVFMFfFbRFVVMHBCCBbfSbfbCVBHBBHbfHVHMMVVffFVCRFFMRVCRSRfBBfRCVBBBSbffV#
#CSbSSBCFfMfCfFVRFVMBCHMVMSbBVbSSFMVRFHVfSfMbHCCCSMSCbHSVCbSSVSRbFSbfBMfHSffHRbSbbSFFHVSfRHBRHRHFSR#
#HBVCRHMfVMMHSHbBFRfBMBVFbRbHfCFRRffHbMSBVCfFFHRbFSMCSBRCCHRCSbffCBCBCSSbRSfbFbSfRBfHRHBbFVMMCBCHRC#
#VfVbSRbMVMFbVHFVRVMRFFFfHCbbSHHRVFBBBBbHBSbMCBRVRHbHMCHCRMMRVSbFCFbCRBFRHbBBHRRMMRRVfCSFVbBfMSBSBb#
#CVRbVHMfMbRBCCSfSFBFMFVRBBfbSFFSVSfbfFfVfHBHBHVRHBFHSBRBBbFCFFfHFBVVbbHBBHVbHbSMHVVRffBFCBCMbRfHVF#
#MBRRBbRfFVbRBbVHBRCMRSfRFCfHFHCBbSRbRVMFFSHHMHfbBHCHfMSMHFbfBRFSVbFMMVRbRVVCFHSfHfBbFRCSCVfHVCbHHC#
#bBHBFCHBfCMRCVMHCbRRHCHfbBSMfBCRRBVVCfBVbVSBRHBfMfCMfbSCFfCVBMCBMHMCbVBBFCBRCFMHHCRRFMBMRVHRBSCfHb#
#MBRfBHRSFFfFSCFVHMbBbSHBRffMBHbBSRRCfFMbBCVHHCCVfFFCFVBSVBFfHHHVHbBbBBSFHCBHFBSSbCMVVMBbCbVMbCfMCR#
#HCCVVRVSSBVBMVBFVMFMRCRSffbbFFBCRRMFSRCRMHbbBMVBMFBFRMfCFCBSRMFMRSbSfCfffRVSBfVMHMbFbVSFHVfBbRFBff#
#bfMbRFbfFHMHRSSfVCFSbCCCRVVCCHSFSRSSVBbMHHCSSBSVBSbfCBFCVfBFSCFFfRCMVfRMRFFSBMRffMMSMHBRbFRMFVMbVH#
#MMfBfCBMCfSFSBHfCVSbfBRMMCHBfbHMCMbMSBVRCCMCCFMVVCbVBFMbfbBMFFSRFCRfHVSSFVVHVbBRMbfRHFCbFSRHSVCfRF#
#bCMbSbHbBbfBMVbbfSFMbbSBMRSFSCSRMRSfFVRMVRVFCFRHRSHRFMBVMHbBBRHMBCBbSbbSRBMVVMCMfSVbbBCVSRSRBbRRCF#
#fVMHCbVRRRCFBHBbVbFHBMfVfCHbCBVbfSMMCCHRBFVbHFBMVRSBFfBCfMVBBMBVHMFCBfVRRRBbMSSFHMVHbMbFHFBHCSRMfC#
#SMRRCbVHBSMMVFVfSVfHSRbVRBBMfbfMfVCRCbBbCSVFRMMSHbFCSVBRMFBbfBfRHFHSBbFCHHCHBVVRFBVFbMRSfVBVHRCVRb#
#fRbHSRbSCRbMCfHFbMBVVbCBRbBbCHHSfSHFMVMHVVHbBRSfCFMMbMBCRCbBbSbfCRbVCCCMFfFfBfFBbVCBMfCBCCFFFRRHVS#
#ffMfHFFbBbVMMRMbfRCMHbBFfVbHbBSMFFCBCRFMVbffVMRSCfSMfFMVFRHMVFfHRbfRfRfMMFFHBMSMVFHFSFSVBfSRMHBHVS#
#FCBfRCFFRRCVbHSfffbHHfCSCFRBRMCMCMbMBBffFfHSBbCHSBMVHbFCCFfbFbHMHBHFfBBfVFbbHbCFCVRHCVCHbSRVRbSMbF#
#SFVFFHCRBfFVSMffHHBCCRbRHMRMBRbFFCHVffMHSCFfHbSRFCbSfCFFSFCHVfFCbbMBMSVRRMRFfCSMBRHMVRVRHBFCBRBCBS#
#SCFSfCCRMRSHBCRHHfCSfMMBRFfBBffbfBbBMFMSBHFMSbbCMSVbMMRSVCbfbBVSVBSSSRVFRbfCfFbbHMHfFMfRCHfFFMVSHC#
#BCBHRVBffCfBbfFVHBfFSSFSBCHfRBbfFfVCVFfFRFBVVCfVSCCCBVHbHfMBfRSMHFbMFSRHRMMfFCffFSBbBCRBSHbHFCCBbH#
#SMFVCfRbRfFRVRCCBBHMCBBBHCCBCbFFbHfSRHfVfHVfBCMCCBBCHbHVVfBSHCRHVBCCVMCHCCbBHVCSHfVRVBHHMCFRRVMCVM#
#VfMHRSHSHCFCRFfFRBMCSRCfFFCfCSMHMVRFBfVHCRCVRfHfRFHCfMVbHFSBVCCfVbfCSbMRHFBfMFCHMMbRfSffBfHSBfVVRC#
#fFHSCHSfCBSfHBHfSbMRRSVHHbfbBFfbMbRHVBbVRRHHRMRffRMVBFBffFHRffBHRBFbBBMCBRCbBbRbRRbVbRBBMSVBBSBCVF#
#BVFHMFRVRHfBRfFSfbVHCBMbMRMFbMSBSCCSVBVCRBffHBCRBSbCHRbHSVFFBbCHFbHBBCCBbVSbBFFBbfCSSFSfMSSMHRFBRC#
#RCfBbBMfbRfVHRMfSHFfMfSHVfMMRFfHVBFHVMBffHFfFBfVbbRbHHfHRbCFRbfHMVbRHHVbBRBCbBMHBfVRSfFHMCVbSMfFVC#
#VSCCSFFBSbHffHRbBCMVBCHBMHMffMBMbCMbbFRVbFFbMCbfMVVRHBSBbFMSVSVVfffCbbbCbVCBFVMBBfVHHfCSbfFBfbbHCF#
#CHRfMbBRCHfMRHMRbCHRVMMbfHBCHVRFHBfBRbFSHHFfMFCCVbCCRVCVBVSFHfRbVBSFFVRVbHMbSMVFMRRVBfRHHfFHFBMFSS#
#fFRSFBBMFfSVRHbSSBBRVffBSHFSSVfVfMMbBSHCMRRVFbMVHMBFBbBfFFMCBMMVSFbfVSMCVCfHCMMSSMBHSCFMbVMbRMFMBf#
#RVVSFFHbCFSCfSHFfbRCSSCMRBbSfMCfFbMBfFCVbVbSCRMHFBbVMbMCBFHHVBbBVHbVBbVRFVMBHBBbFBRbVSHffFRHRSfRfB#
#bBbCMBFFfMSbFfMHSFRbBBFSMfbSVCRSbHfRSBbbFFBFRRfbCCbVCBfBCfMMFVbbHBVSVSSMSFbRVFSRVSVRBSHMMSRbBRSRBf#
#fFVfbBfRbBSMFMMRBbMCCRbVVbBHSSbFCBHFHCHSCSFCMHfMHfbFbBRVfSHCHSRBCCfRMCbFRbbbbHMFSfVCMbHfCBfVMSSfFf#
#BSCSMMRVMBCSHFHCCRSFFMRBBfMHMSFffMRFCCFHCVFMHbbRFHRCFfbMBSVVVbVFMFFHFVMCBFSCfVSbVCRRBBBbfMBRFCbFCB#
#bHfRHfCfRBSfRFbfbSCRBHMfRbSMVFbVFbbSFMFFVCffRbfMVRfRBFVFbRFMMMRCVCCHCVHFSffVCbBCBMfBHCfbRBffCRffCC#
#MRMbfHbfMbMfCRMMHFHCRRfHVFMVFCBRHCfBfFFSHRCbBFRfCCbBHRbSRVSbBCFBSfVbbMfBRbSVFHCCfHSbCHHSHfRVbVbFSF#
#RSCbbFSSCHSSbFRbCSBbHMFCbSHVbFBRRCBVbbCVMCHMFFRfFBHHHBFHVRfCfRMMHCFFSSfCbVFVRVfFVfMVMVMBMSbVFfBHRS#
#SVRbSfHHRSVfMSfMBRbCVVBVbRCbRVRfMHCBMMSRHfMFRBbRFMfSMHHMBfCfCfVBMRCHRRRbBBbbFVVCVHBBFRSBFCRHSBCSMV#
#CRbbHBSFRMSCFHbbVRCCRRFSFCRBfCSVVSBFffRRbVfbbRbHCbfBfMFSfSfFfMVbCSBRSHVVSVFHBVfRfVVVBRMbHHfbVMCbBB#
#MVSfVfCRbFMfFfCFRFRBSBBSFBRbfSCVfFSCRFSCCBbRbFbBBRfMbHfbbRMbfHfSbBMHFCHbBHMSVFBSMCVRHVVfbRHVRfMBHb#
#BFVCRCSFHFCRCBVbVMBVBFRCMbVVHfHMMbBRbFbHRRHBBVMbMMFHRHffVbVMBMBVCfBBfRVbSFVHfBbBVHHMSCMFHbBBHHfVFb#
#BMVFfCFCbMbBRCfVVCBbVVfBSRbHMHfFSRSfSCFBSFVSfSBSCCFHfCVMSCSFVHRRSffbRMVfRVVMRSbBMHbVbfVbbFHBVFCHSM#
#bbfBHMBVfCVHVRRMfBCHbfBfRRSbFHFMCFHCSBFSMFSBHSRSBVCSbFSSBMbBHRFfbCBRbfbRVMCfHSbbFBHHFSFBbbbHfSRHBf#
#CCCSBBbffBFBVbFFVSFbBMFBFfSCfFBCMHbSffCVbMbFRBHVfBVSFVVbbHMHSfHBVbVVBCfVHBFMRMVFRRMRBbHVRMbHMRfCHB#
#CFMMFSfHbFfHHFHMCRMCBFRbRfBHCfHRCSSfBRMFHfbCbbCBFbMFBFVHVFCfVSHVBHMRfSRRbfFfCbFVBBRMHbVbFMbSbFFfbS#
#bHCfCMBbVVMRRBCMVfMFbCVFCbHFSRHfMMFbbVBpHbfbMFBbHBRFHCHSVRbMRMBBHfFMVHHBSbSMVVVFHMVHbHSVfHCfVCfRSS#
#MHbBVHfHBbBBFffRMVFMHFSVCHHbHSHBFfBbVHbfBBMHfMRSBbSfbSFRMSMbMFbMfHCVfRCVFbVRfBbSFFSRbFSVMbCRfMSRFb#
#bMVBFBVRHBSFBbSCHSbbHCHHVMVSVbBMSMBbRfVRbbbfHVCCBHRbCBCBMMVSCHbCMbFbRBMbHRMSFVBCVMFfRHCFfHSMHVMFSF#
#HbbMbfVSMCSbFMFVVHMRVSFHfCVHfSRbRbHMBVCMfRBMfSfSRVRBCCFCBfCBbbfVCFFHBbffFbHFVfbFSbRSFMSMHBMBHVSHSM#
#bVHFfCMMVSSRffVfHCRRfBBMfVFSCHBFHRRfHCbMbCFFSRHMVfbfCfCBFFHFRMFfMbSfCfBVCCbBFHRRRBSCRRbMFHRBHBSMCf#
#FVfRfFHFHFVMHRfRCSbCffBbBBRFCBVFVVbBBSFCMHHFSCbCHFbMMRCbBRFBFVBBfBfbfbbHSMfbMfbBMVCSCbfFMSMHSSbMbf#
#SSSBRBFMMVRMRHVMfFHMSCfVRCfHMVbMHBRCbCFRHMRfFCbHCSfFBbCHbbMSBVSBHMFBFMbHfFFVHSSfMBBVFBBVFHfbVffffR#
#FVfbCMBVFHSSMFMSVBHVVVCVBRMfVbBfCBCBfHSMMffBVBbVfCfBFfbbSFCVCfHHFbbfFMFFfRFCbBMMRVFCFbRMCBRFbSSFCB#
#FRfRVfMCFBCBHMCbVbMbHCVHSCHSSCbVBVbHCfRRMfHfVfBCHfFSMSBFCbSRCVCVffBRCVHCHbBCCVFBFFHbVCRHMRbbFffCRV#
#CHBfbSHSFbVHffBRVVHRSCMfHHFVCCHCVBbSMbbbSFBHSRHCBfVBRVBCBBfHMRRVVRFfHSVFVBMHfRVCbBFfFCHRVbVHfRBffR#
#fFMHMRSBRHfHRSfFMRCMfVBfMMffRCSSbHHVSbHfFVBRRRVMSMSCRSSFBCfHfbRfCfFFbRHMSFSfSRSFRBCRSbfRRRVVfSRHHb#
#bFMbVHMBRBSHHRfCHRHbMHbFBbRVMSRMbMRRffbCBfbbHBSSMVbMRSVRbSRBCHVMFBMSHMfSHVVHbHfSRBfHVCfVbMSfbfVCCM#
#MRSMCVbSSBfBVBHffHFHSRbVMFMbVFbRMMVSBbVFBFMRfCMffHHBbHHBSSfCbHfFFfMVCBBFRbRHMRbBbMbFHCbFFVCSBBMBCV#
#FCBfHCBVVSRBbRMFCbCbfCCFbbFbCCCMMBBbVHHCSSVFSfRSVRbbMMCRCbSHVRSBVHMMRSbMRfRMbbfSHbMSVffHBSCbMVfFFC#
#SFBFCRRFMHVBbHVHfFfFFRfRFSfHCfHbMfBVBffVBSBbMBRMVFCVbBfVHMVRMVSSSbSSVRSHfBHSRRHFBHCHSMRHfHHVbHBfCH#
#fRCCfBCMRFFMbbVbSHSMRVMFMMHSRHbCbCSHBbRRMSbMFCHBbHCVMBVMRRfMMfSMbFBCbbVFBbVFSbHSVMFBffVVfFRBRCBSMV#
#SVMBMbVfbfCbSbfHSHFFSSbHMfMRSHbRbfVRSfSMRfSHRbHBCSSHMfbbMRVVfCVCVMRBSSfSbfHVbMbFCHCCFfVFHHHMCHCbRb#
#CRbCbbVFBBFHRMCSSCVMBbCVMSVMbCCMCVSMfSBCFRbCFfSHSRMBfffCbbSVSfSSCHBCRFHHfMSVfFMHSSHHFMCfFRMRHFMCHB#
#BMCFbfbbbHVCBMBRFfRSSFVHVHCRfRFMRSSFSCbFffRfbCffBBfBFHCfSfRBBFMRVBSMCMSBFMHbFFRRBBFSHFSRHRBHCRFBCB#
#RCbVfBSMSCRRSSRRMMbfBFVRfMHfMHHVVCbbCSMfBbHVfCFHVVSCRHRRBFCCMSVRMRRFVCHSMVHHbFfMSbRVSFMFSFCfSBVFRb#
#CSHMCSRHCHVVBSRVRHBBRbfbSHRMfMRSSBCVbRfbHFVBCVSSMVHHfRBBVVSSfCFSSRCRVbCfHMFVFMCVRVfbCfBCSSbFFfSCRS#
#RBFSbSHMHbRbMFRCFBFSbFHfHbSSbBCRMfCMfVBfSRbbVCBSCMVCbRbbffSRSVHfVHFVfHffVMSVCBCbBRVFBRSbbFRfFbBMSF#
#bHbHRBCVHBHRFMFCSRHbVbSfFFMFFbffbHHSSCFMRMBMRRfBMRCHRSVVRBBCSVfSHMVbFSVSFFCfbbFFMSSbFMMCbHVCHSbBBV#
#CSbBCRbfVbMCVMSVFRSCVHRFbRFSfFVfRBSBFfFfFMbFbMFVMCBRFRHFFRSBHMSbVVRVbbVSRbHfFSfFMfFBCMHSCRHbRFfFfC#
#fbFRMHbRVSCFVBFMMHMBRSHfHCBfHbMfCfCRMFffMMSSSbffFVHBbFfSFSMRCMRbCRfFFRfVfHRbBHRSbMMSFVRRbSBFRBSFVM#
####################################################################################################
