####################################################################################################
#MMRCCffHfRCCRBCfMSbRfbbHMbHCMMfFbHbSMRFFHFfRHBfSfMCSbCSRHRHCbfMbRffHbBCMBbHCMSHMFHbCbCBRBFMRHSCbSR#
#CMRCMRfBfBMBHBMfbHSbFSCCMFHfbSfRHCCMbBRfSMCfSfMbMFCCSBHFHBFFfMBRSFSRBRRfCffHHCCfRBBFCRfbRffHMBfSRb#
#bSRFMRBMfCHfbSfHCBHCFfHfbCRRHfMSfSFHCBMRCFfBRSFMFfRbSHHBHMCSffbRMSHHHCBFSFCfCBfMBfBfBSRHCBBRCRBMMb#
#BHCCRRfFHfMRCCHCSFCbBFBMBCRbfCCbBRHHRfbRSSFRBMFHHBCfFMCFfCMHSCRCfRfHFBfSfHFRMbbCHMCCSRfCHRRMBFMFCF#
#FHfFCBbFSbSHBSbfSBRCCbFBRFSCbSSFSSbBFCHCCbFCfRHHfMSfFBfFSHCBBHCMFbMFBSfRBBSRMfFFBCHRbMfMRbBFMFfHfS#
#MFHMFfMCbffMMfbSbRMfbBBbFBHbHbHCfRSHFFMbbFFHBBCHfFCCBBHMFfMbfCFfCRHCMfCMSMCHSbMRHFSBFfRCCCCRBCRBCH#
#RfbMCMbfHSbbHRSMFbSBSCCFfMMfMRbMfHbbCHMBfMFCRHFBbFSCRBSRMFbMMFFBbfMFBbSRBHHBbFSbBRHbbHSfMbfBFFbCfH#
#MSMBMRHffSRCbCRBRHSffbCBMCRfRFffBHffRHCSbHFHMRMfMFHSRCRCbRfRHbSFSFCMHRRbBffHbCBRRMfMSCfFBFHSBfCfbS#
#HHFSMCHbHfBHbBSFFfRMfFSMFfMFfBbSbfFCMBMHFMbRfBHCMCSMCRSFFFSbbFBRfMBMSfBMffFCBHbRFBBfFHSFFfbFBfBbSH#
#CFCfCFbSBRBSbFRbFRMBCBfCfSHHBFbBFFbCRHBbMMHbSFfRMFbHSFHHbfBSMbHRfRRFbfbMBBbSBSBRfRfbFMbRFfRCSbBRfH#
#MfCRSBBbRFffRRSfSFSSfSfBFRMFbBCHFSMfCMRRHHSBHHfbHbfbHCMBFfbBSCbfbFBSfSBfBFSbBFFFRbRFHBbRRCCfCBfMMB#
#RfRFfBRRSFMbSHfRRRCSSbCbSSMSBffSBCBFRMSMHfBRRFMCRBSFMHBHCSFFCMfFMMCHfMSRFFMbCbfFBRMFFSMHRfHCHHfHCf#
#HFbBHFFbRSHbFRBFbFbFbRSfBFbfSSffRCbRRfFRMFSCHFCFHFCFRHRCHFFMBbBBbbffSMBBMRSSbBSBCSbbFbfRRbHRfHbCBB#
#CSBCbHbFBSHbbBSBBMfHFHRRMbCRCMRMMBbBCFCBRHbBFRFFbFFFHMFHHCRMBBRHCCbHHCFRBfbfSFFRFMRCMFMFHRBCBCHHBb#
#fSCBMHHBbbFFHCfbfHBSRSSRBMbCfRSFHHSFHbbFHfRHSBHMSRCBMFBHHMMMRRFffCMCCRfSFCCMCCFfRfBRMbFBMHbHRRfRHB#
#FCCfFSFfRFbHbFRBfMCMFFRHCRBMBSRFRFSfbRCCMbbHbSSHfFBHHFBCfCRbMBHBfSbCFMMCCbFFHFFBMRSHHbCBRbCFbffBFS#
#MMMHBCBSMMMBFCSbRRCFFBfRbCSFbCbFbBCRfBbfBbFMbSFBRRbMBSSRfCHHMRbHfBbFSFRMFSBRRCHSRHRCBMbBBMMbRCRfHM#
#SFMHSCBfRMbHffCfCfHCHSHCHRRbFFHCHRCbRHfBCbBCRbbMHRFMHFMBCbBRFbRRbfFSBbfMRFSMfRCbRbbbSBCSbfBHHfBfRb#
#SBFHSfMFCffSfMMBCFSbMSRbMFBfMRSBbMMbCBSfbMbSBRCfCfbFMRRRSSbFSSHbMFRHFfBRCCRFHMSRbfCbMbbHFRRHBBbFCC#
#fffCfMFMfCRFFffCBSSBRSSFFbHHFRbBRCHRHFCSfMRBCFbfHMfBMRBfCHRfHBMFCRMSFMfRfFBbbRRMMfRCMbHSRCMRbfbBFM#
#MBFbfMRFRFCHSbCbSMMHRMSMSSbHBHBfMfbHBSFbbCCbRHMHSbSSMMFCMFfCSFFSFFbCCbHFFCMSMHbMRHHBMRSfSBBRMbHSbM#
#FSbMFRHMbfRCRbfHSRMbHMHfSBBBBRFCbbBMMMbfMHFHMSMFbBFSCMCRBCfbSMCFBBRHFMSfMMCFFCfMfMBMbHbSbHSMSHCbFb#
#fRSHMCFMfHbfbRCHHHbHMHFMSbSfHCSfCHMHRRBFHFCBBBCRFMRHBHFFFSMbCCSSHbbRBRCCfFHCSSCMCRFFRMRfbHHffHMHSb#
#bSHBBSfMBbHCSfSRHSbHRHCHCfMfFRCHbBFFFSbFFFbCMRfMbBHRMMRMbFFSbRCSFMffCSSRRCCHRBMHbRFBMBfMfbHBRMCCBH#
#SBMRBSRHRfSBBRbHFCCFBBBBBHfBBFBSHHCBCfRRBRfMbFCHSbbSCbHfCCSRBFbRbMffHFMbFSHbHCHMCHHFMCCCfFBfSbRMbM#
#bbMFRMBfBCfMBHHFRCCRFRFHMbFMRbRfMFBMMfBHBSMBHFSFBfBFHCRCCSCBHMCMMMCMCRbfRCfHFMRSSMFBMSffbRHbbCFSBb#
#RCRHbHRRMbHSSSRfbHBCfMfRbFbHCbfFbFFBSbHbRCBSbBSMCRHfFRfMSRFHfMCCBSbBCFSCSCbCBRFRbRMfCSbFfCSbMbCfBB#
#bCBSBFBRFHbbbfBBHfMBCfHRRfbBSFbbCRBMRSBFHHCfBBRBBBFHHfFFfCCHHMRBHCSbHSCRBfBSfFBHfMCbCCBHMCSRfCRfCB#
#SbBSBSBbfSfRSFCRfBHffRbSBfBCMMbCbCBCHfbBffRRfCffHSRMFbBSSHSHbFBHbRfBSfbRCBfFfRBBSCBbBbSffCFMFFfbSb#
#bfFCCfbCHBCHRffCHFRHfHbfMHHFSHBSSbbFSHCRBRFRRFRSRBMBMSHBFCMSfHRHCCCfSMFRCFRCCbRCCbFSSRSRfSbFRMCCHM#
#BFCCMRBRRMfRffRMbSBSMMMSbMMBFBfHbCBFRbbSBfffMRFMSCBHbHMRCFHBffCBbFRFbFHRCbRSCFCFffSMHbHMHCBfRfCCFf#
#CCCBCHRBHbHBMSCHBSMbFCfCSSfffHFBbFfFFBCFfbFMMFFMHCbBHffMHHHFHbRFFffBHCffbfCRRBbBHfffMSHHbfMHRBfMFB#
#fBMRHMMMMBCRbbBfMbSfBCRBFSfMbRCMHFfHCRHbCffFfbMMBRbBbfHBbCbHbBRRRRRMfSMRHSFHHFHHRSfCCbbMRHRBSMMFHB#
#CRHbbBFFBCbfSCSBfFFHSbCRBRCFMHfRfBMMFFMHfRSFBRfSMBFMbRHbFCHHSfCbSfMfBbCFCSfBbBSMBCFSCfRRHFMRCSbCMB#
#CSHfbMCMHBRSSCCfSMMFSbBBbBMMbSHSSMBFHffRSbHRRfHbCCHSHfMMFBHMSRMSbHfMCbMBHSHSfBfRBBCCBMHffHRCBCFCRB#
#FBRMMBHbHMFffSSSbRBSFBSFSMbRMbFHMRHCRfBRFRHRSRRMCCFbfHHCCMMCbMHfbbfRRffCBHRMbRSCCMRSCCffMHBRRFCRCM#
#SHBMFSfHBCRCHHFCFHBCBSbCRSHRbfCFbRSBFBRMfMMMMbBCMBfRbBHSBCbMSHFRFRRfHHbSCCbFfSRMFfMHRMMMSbBCSBbHCC#
#bSBCFSMMCCHCBRbSCFHHCfRHSbCHRBbBFFSRFSMSbCbBRbMBHRfFMFSHSbFFfMFbMBRBSHbMRCMMSfCfRRCSBBHMHRHRfBBFHF#
#fHHCRbCSCMSSCCRBRRCRFffSRFfMbSSbMBBHHBffCbbFHbSHSbBMRRfFBCRSbbbfBfSBFfRRFMMSFBBFCBSSBHFHHHFBRFRBBf#
#HffHHbBMbfFMFfSfRMffCbHfBCBRSHMFRbSMRbSSFMFfFRffRbHCRBMbMHbbSHHCMRbRFCBFbMRCSfHbCCCCCMBfCSBCFSSFSS#
#MbfHRFFBbRMCSHFFSbMbCMCfSCBbHCRCSMHSHSSfMSBHCBRMMHSSbBRBBfCRHfMBRMHHSFfFMFCRHCHRFHHBMRHfMMfffCFMBF#
#CbHBfBBbMBbSBMMbbBRfRHCHHbFMHCfRFHRFFbBMHFMCfHfSHCBSRBHSBHMfRRMHRbHHSHfFHBSMRCfSCSSFFFFFBbFFfCMSRb#
#CMHMbCfHFSMMFbRCHCRfBBfbHffCRbbBMCBHMSfSSfHSBRbHRRfCHMfHbCCRFHRfBHBSfBRMfHffbSHRMFfRBBBBfRHCHHHMCM#
#CHFBbCMSCCSBRfbFBbSRSFRHRFFCFMRbbRCBFHHbSCBCMSCRfFFHRBRCCbMbRRFFSFBFffCSFbffBfFFRBbBbMRSHMHMCBBbCF#
#SfSbCHRfMRRRFMSCBSFfbFFbRSMbSHbBSMSFSfMSbSFSfMFHSbSHHRMFRFSBCRHCCCHCbMCRbBHfSCbCFfCMHSbMbHRSCRSRFH#
#fMBfbBFFBHBfFBBHRHBFHbFfSBfFCMMbfFBBCSBbfbRfBfMSSHRfMRRBbBSCFSMHbFSSfCbFBMSfFFSbMbfCfHFfBBMMRBffHR#
#SbfCCCRFbCMCBHHBfSbHFbHfSCBRSCCbCRSRfMBHHbCCSRbHBBFSBHRMFFSFbHbCSCMHHRBMFSCbHRBbbHHbBFSfBHMRMCRFBb#
#MMSFBCRMRHMHSCFfSBRSBfRSRMMMBCFbHHHCFbBHMFHBFCFSSfHbbFBFSSFBCHSCFFfCMFBHRRCfSBCMbSFMBHHfCSHFfHCBRB#
#BRCRBbRfbHSHFRbfMFSSfCFMMFMFbfHfMbBSBHBHffSMSFFHMRCbfSSMSbFbSCHCfBSCHBSRBSFbHRBSCRfMCRMSHRFbBHMMHf#
#SCfFfBfCSfSSFMMMRRCbFSSfMCfBCRfCRRFCRMSSRFfBBbbRMCfFBSCFCMHRMSRHCSCBCCCBHHbbbHSFfbMHRHbfMHbRBFfSHC#
#fCfSHffCHCbHbfCMMMbRCfFHMRHfbRfRBMSRFBCffHbRMRCbMBCffMHRBbFRCfCMMBFbfCCfbCBCCbfCRCBHMSfRfRSCbCBFHC#
#FBHCBSSSMSRFBbBbSHBFbRMMBRMCMMHbbCfHRSbfHFMCFHBfFBCHBMFFfbBCCfSMbSHfbfFMHRbBfSfCFCCBbSSSSHSRRHMbBM#
#MBbRHCbSRRfbCHFfRMFFSCBSSbfSFCMBHHFHSMRbFFCCFbHHbfbSCSbFCHFSRBFFfCFRRBBCSSMSfBSHMbSRbfMbRFCSMCfbHH#
#bbRCHCbbHCBMMFBMbbSHFffCBFbRCfBSBbbBfFSHCffSfRRHfMCBSMbHBRRHfFfRSRMRbMbSRfCBMBCMMSfMbCbHBCBbbRRfSF#
#BMCbbRSHRMMBfBfFRFHCBCCSBHbSBCRSHRMSCHHfCFbfMMBbRBMMCBSHbbMSSBBCCCBRCFbHRbBFCBCRCMfBRFFHRMCfbSSMCC#
#RSFMHMbfSfCfFRCCMfSSMbFBbCffbFRSFRSMbSSFSRfHCHbCCBCMFfFbbfSRFRSFHMRBbSCMFfSSbBHRFBbSfBHSFMfCfHCbMF#
#MMSfMbbCbSFRFMRMMRSbHHfSFFRRFffHMffHSMCFHCSSBFSSCSBCCfbfHCBFSCBHMRFMBbbBBfMFCSSRSBSfCMBRbMBFFBHCMB#
#BBMHHCSFBFFRFHRCSRCCHCMfHbBFbbSbHbSSRRMFSFFMCfHCfBRfbBBHbbMSCRSHSSCFRSbFCFbfBCSFMCRfHCSbHMRFCbRbHH#
#CMfCCHfRbbBFCbfBHBBFbSbbSfSbbbFbCFBHbHfBFCFBCFMSfCHMbfCffFRSbSHbMbbfCMCMBSMbBHMBFHCSMCBMCHbbCRMCFf#
#FMSCCMbHSHMRCRHSBSCHHSRRBBSHRfSFMfHSBRBfCCBFbCSSffbFHFHSfFCRFHCbHCFbRfRbHfbFBbfRHHSMMbHFMMCSCFHSSF#
#bbfHBCpFMSHHBMBBbBFbFHBMSFMSFbRCfBSCFRHbCCCfCSMSHHBHCCBBRBfFbCfMHFMCBHMRBBfbSRFMSRHSMBRSCfFRRMBSSb#
#bBFMRMBbMMMFRbfBCBHfBfHBCHRHCHHMMCFCCRRFSBFbBCCRSHCSfCfHHBFCBCbMFBSFCbMCMFCBfHSFFffCSfCbbSBMfSbbSH#
#BMMHffHCFCMRFfSHbfSCSSMRMBbRRFffCRHHFFSCMRbCbHBFRMHBfRBfSFBRbFCRCHMRSHbCBBfHbFMbBSCbMFbHHHMHCSBbMB#
#CSMSMHFfbFHSSBHCRRMCCMSRSFBMFSRRMFRfRCHSbFCfHbFSfBfMMRfMFBCRCRBBFfSFBRHFFSMMFMHFFbMfBMHMRHCHHFfFRS#
#RffCMRCCfHCCHCbMFMCBRMbfbSMSMBSfCSfHSRFSFbbHRSBBfbSHCbHMFFfbSbCbCFbMRSbfCfBbbBCMCCFfHSRbHFCMFBSMbS#
#CMCbHBSMBSCFMSbRbMHRbCSMFBFFCHBFHRSHFbHfSFBFSMBSBbffRBSbCHHFbCBMMMCMfMFRHCBHMFCHCfCFfMffCbMBSSBSff#
#fbBBfBfRfHBHSfHMMMHMHbBbbBHRRFSSFBSSHFCMSfMBBHbBHffHSHMbFFHbbBCFRBHSbfBfFHCbfCHCMSSHFHfbFHCFMHbFCH#
#fFbBSBBbCCfFFHCMBCHFCbFBfFRMFBSCMCHBCRMbRBMRbRBSbfFFHCMMbCfCHfbSCSFSFFfSbHfCfbfbbCFCRSCFHMFbMbfSCH#
#BbffBfFHFfbSFCCbRfCFbSBfMFBffSbCSCfFCMFFbCbSRRMbMCFbffCbSCMBMBHBFMHSRfBCSBRFbRCffMFRFMSFCRSbCbFbMS#
#FbSBMRCBMMSFRbFSBFBHRRCFHMbBRbCfSbRFbFRHCCCBFbSCHHRHFbBMHSMCffCCbRSCBCSRSCCFBSCHSRCCMFfBbbBCCBBCfH#
#CCHbfHRMSRbCMHBbbBfMfHSCBSMBCFCFfbbCFHbHRHSFFRffbBFfCHbCBRRFMMBFRCbbSFBBfCHBRfCHBbHSBMbSBFSMMBMMSC#
#bMCCFBSFFFHMHSCFfMBffHMBFRbfCMCMfCCHBFBHRMBSFFCbMHHbSRMHCbMfRFSFBCMRfbMFHbbSffBMbbMSFSbSfSBCMfHCbb#
#BffBbBMfBCbMFfCMCHHbCCbSSRbHHCBbCBCMRFfMRfSRHfSRbfRbbCbFFCHMBbbCbHCCFBbFfMMBBRRCRRfSMHRBCBRRMMCFRM#
#bBbRMRfCFHBBfCBFCbbbHRSfRSFSBSSfFbHRMHfMHHHffMfSbRfRRSSSFFbfbFCHMCMCFBBbFCMRFfFCMfSfBRRbfSBFFSMFCS#
#MfMCRSBCbCBSCSbFFCfRCBRBfCSbFfMSRHMFMCRfHFbRSSMMSMMHCBFbbffRSBSfMFSSSFHHHRBCSfMCfRFHMRbHbfRFffRHRC#
#FBfRBFBFRfHHMFBBBBSbbBCFCBRfbMMfHMRMBfbbfbFFRCHHfCHCfbbCBSRfHBfFRRCRCCFHMffMMMRRMfMSCbHRbHMBSBBSHB#
#BRFSHSFfbSSbMCSbMCSMHfFRFBbffSCCffSMBBRfffRCBCMBHMfRRfMSbCFRCCMCMHHbHHSBRbFfFfBfSbFFbCCfSMBSFHBBMF#
#bCbMfSCMfFMMffbFbBRfCFBRSHHMBRRRSRfSMCbBFCBFCBfMBHSHMbFfHHBSMbSMSSSFBHMRRbCHbBRMSMBMHRfHMCMFCRHHRM#
#HBHRCbCHbbfBbCMMbRbbHfBFfbHCMBFBRFHFbRCBCMBfRbfHMMFbRSRBCRMBfFbfSSMSfMBbHCHfCMbHMFMbffFfCbCSHFBbbf#
#fFBbCRCbbMBCSCMCBCFCSHHMMbFFSFCfbMHMBMBHfCHFMHBRHFbCHFRfCMHbHMHffHHMHMRfbFMBRCbFfFHbBFfFMRHbCBfFfH#
#FBBCRMFHHMRHBMRfbbBMMBMSfbRbRSFCCRHFffCbCBCBFfffMMBfRSCCbHFbCCbFfbCfRfCSFRBSbRBRRbBfSbSHfCMbBRSHBB#
#FCCbRBbSfMHbBMMCFbRCFRfFFfCHbBFHfCfRRMBBFSHfHRSBMBRSHfFCMSBFRbFHfbHRFRRFBbHRRCHRbFSbSFSBBHFSHHMCFH#
#RCRfBSSHSBfbfCMFHRCSbMMMFfFBRfRCfHMFRRCBCbHfbSSHRMRFSFBCFFSMSSCRHfRRFMBHCRfRSCCCMbffMCHFRRRffRFCfC#
#RfBFRFCMBBBMFFMBFbbRCMfCCMSHbBBfFHRBfRSfFBBffbHbBBCFRFbbFfRBffBBHRSHffRfSRCRRbMfFFMHHBbRRBCCFBRfFR#
#RbFHHRRbbbHFMHFFbMCbCMRMCSFHFHbRRbFRCFBCFSMfSRFMMfSfRSCBfbMCMfBHbCBSFSbCMHCSRHSMHFCCbRMFCBCHSHBbRH#
#BHRFCbCHMBFSBFfBFCCFCCbMBCHSBHFFBHCHfHSMfbMBHbRSMSCRMHfSRHMRMBRBRbMMSBHSRSMFHRSbFCbHBfHMfMRFFSRBfF#
#CBRCSMCBHSCFfBbMfRBfFHbbRMMbMFHMRRfBMbMBHbMRMffFbfCMSRSSSCbRbbfHFRRFSCBSHfFfRCHBRHbMMbfFHfHfRbRCbf#
#SFCHbbHRRfRfMBBSRbCCSbFCRMFMHFHbMBRRBHRCRMFSBHBCCHCRFBbRSfBbfbMMBBbMfbRRMbFCHFBHCRCbbRfFFBFSfBRCCM#
#CRfCMRfSbRHBMRHBFCbfCHSRMBffSSCSfCFHHSFSMfMMBbBffRbSSbMRCBMHbMBMfRRbbRBHSBFSRMFRRCRCbRbBbCBHBFbbFS#
#FHFMRFHbRHfMHSBFRfRFBBbbSFfSHMSSbMbSMBHfCfHBMBFSSRfbBSbHHSfbRHRfbCRCbCbBfCRCCCMRHfBRMbMHRRbHCFCSbM#
#HRBffSbfHbHHMCCbHfMRbfMfSHSfbfMSMCBHCfCRRBBRFBMSBCMFbbFCBSCfCHMSBfMMCfMBFbHRCBfBSCfSfbFRCfbfRBMBbF#
#SCHBHfMRfBSSbCbMbfFRCBbCFbHbBRbBHRHFMRCRRSfRFBFbFCBCCSBSMfRCFCfHRMSFHMSRBMBFCRfRMHRfbbBSRMMHMRbRHR#
#CfMRCRbbCHBMRFRRCCMCbSHFRbMRffBCBHHSHHHMMRSRbCfRRMfbFBCCSbBbHBMFRSHHfFHHCMHfSbHRfMfFBBBFMbRMSMFSSR#
#HbfbffHBMMMRSBFbMRRFbbCffbbCFCFRHRMHBRRCbSCSfbBCbSFffMRbMBSMbbRCBCFMMCCBSBFSRFbMBSbbHRfbMRBBbBBfHC#
#bRBRfCBCMSHHfbRbFFHMfBHCSFHSHMBBRbBSMBHRHfRSCSBfRBCFHHbSRFBRCbfbRMSCFCHCFFbMFBHfCFCbBFHMbfSbFfHMCM#
#SSSRRFSBSFBBfbRfCBSRRbfbMHHMbfRHRCHfSCCFbRMBFFCCCbbRRCCMHRMMfSbfHFFBCHfbfSfCMBRFMRHSffSBRSbfSfFMMH#
#BHMHbHCCfBMBHbHCfbMFSHBSCBBHfRHFHFFBfCBHHCbbMbBSCfFCCfMbbCHSRSMMSHbRbBMHRfSSHfMRCRFCFFFHBCfFCSfbRH#
#FCMffbRfFFMCMfbCBMHbCRRfBCHSbBSfHSCHMbRfMCFRHffBSBFCSBRHfRFfSHCSMHBFBCCFbSfMffRSSHFfMMCbMbbfBSRRbB#
####################################################################################################
