####################################################################################################
#HCFFMSRMMSHBBBCMFFRRbfRBbRMSRRMSFbRbbHFFBbCfSfbSBFMMCRFFRRMSbHBCMBbffRFbFfbFSMRfCbfCCRSCfMfMFBSRFf#
#BbMbfBSMfFRHCbHFRMfbbCBFfSHSBSCRSSfBRBFBMSRbSbCRMMRSCMMMffMbMMbHBfHMMBffMBHRCfSRfCSCFCfMRCSSRFBBRf#
#SHCSRSHfFBRfBSbBBBfbbMRCRFfFHMBCFHbCfbMbHfSMBFRMMCbfSRSHfbbFSfHbbffbfSbCBRSRMFRFCFFBfFRHMbCbHfCfMB#
#fHRSBMCFfbCfHCSMSCCCFfHCBfSBbbbBfBFHSRSMCHBMRHBbBBSMHBFfbBCMMbMfbfFHSMRfFHMfMRSFHBMFfbRFHFBCCfBCfH#
#FSRFFSCSSfFMBRBMRBRFCMbMCbMbSRBFHbMbbCMRBMCFfBMBbRCHCFMCRFSCRSfFFfFRbBSbfFFFfRHFfSMBSCMRMMSfRBRbfR#
#bMSBMBCBRHHFCRfHSRfRRBBCHSMBCCBSRMRCCFFSHbSfFHSFRBfRCRMSfCBfHRfSSBMMHMCffbHSCMFMBMbRbSRMbCBMFHBbbC#
#BRBMRSBFMMbSFRCSbFHMRMbCFCCHbFRFRSBCSHCSbbHfFCSbHSFMbFMCfHMRSRHbCRbRBfCRbRBHfFbFfFSBSbHRMfSHRCbRbR#
#fSfBHCBBMBRCFMRfFRBHbRCRRHfbHSfSMSFbCRBRHCbHBMCCFbFbBfFHRFSBfBBSfMHMbMSBbBMBbCBRHRHFbMRFMHbfbCHFfC#
#FHSMfSRfCCffFFBHRFRbHbMHMFSBHfbHRMMMbbHbfBSBCHfMRBHFbMRBbRCHHHRSCSCMHFffRfSHFHMBSSMbSRfRbRbHSCbHFb#
#BfBBMbRHMCCMBBbMCFMRRFCSSMFMRbMbBHbSHHbbSMFFfMSBfCHfbRBMbCFFCRbMMCFRSCCbFbCBCbMRHRBSMfHfSRBbbBRHRH#
#BCHSRbBFCBMHCbHSMfHCfBbHSMMCSCSSbHHBMRBFfFMMMHfMbRMbfSMCMHFSSbBbSMRFCMbbRCCCfFHBRHBCbSHSbRCMfFMRRC#
#MbRSCCFRFbMRbSRfbCFfFFfMBFbFRSSBCMCMMFMCfCHFRBHFfSfbfSFBFBfbBMCfSBBHRHbSfFFRMbFfMMCbfFbRFBffHfHHFb#
#HfbRMBfSHFHbCCFMbFHbSbMMBFRfRfHSMFBCSbRFBHCFHfFSfCfCRFfBCfbRfbfCHSMSHSRFMRBCRCCbHHfBSfHHCbMCHHbCBC#
#CCSMSbbbCSFbHfbbSBFHBSCbHfHSbFFRHCbMMbbRBSRBSHHFfSbBRSBRCMRHBfHBBBRBCSbSHBSBFSMSRRSBRbSbFSRRFFCBFf#
#bMBbBffHHbMFCRRFfBHFCBHHRHFfRHbCfFCbHMMRCBHbHRBbCFMbRbBfSSFRfFCBBFffBFFHRbfSFBBBRFbbMMMSRSRBfBBfHS#
#RRFfBHBBSBCbMMHSSSCbMFbHHBbBFHbHBHffRBBBbfFSBfFCHSfbHBFSfRRMMfSSfFSbRCHfHCBSMMRHRRBRFMCHbFBbbRCfSC#
#fMbFFFCHRBSffBSRBCRSMFMBMSRFbbBSHCCCRBCRHMBfHBBHfRBbRCBMSCHFbSRHMMfbbbHRFFbfbCCFMSFSSCfSMHFCMCSCCb#
#MMRCCFHBBFFBSHHFRCBHCFbRRSbCBbCfRSBCfMRBRFbRMFHSHCBBbbfMMBRSHBfRSFSbFCHCbSbFCCFMHSbSBFBHSfSMbCbHRC#
#fBRRfBBHRfRFFbCMbCfRRHMMBSSfRRHMSCMMbSbMbCHHCFRbHMfMRRfMbBfRCRfbMFfHHHMMbFHHbMCMBHRbFRFSRSbbFRSCfB#
#HfbCbHMMfSCCbRCMbHCSRCfFSRFFbbRRCCFbbSBfRSSfHCMBbRMbBFBMCHRHSBCSBCfbHRBfBFBBRbRSMSHCbRCbFCMMBBCFMM#
#FCCCfCfBSbRCMBRfMMHFbFRBHFBMSCSHCSFRBFCFFSffRbSFHCfCMRBfbRHFMCHMBRBCRFbSFRfSMSBCSBbMFfMRMSHbfBbCSb#
#BMfFMMHSBRbCMbbBFHRBHBRCHCSMFFfFCHSFHMMCCbBHCHHRBHffMRFCCMHCSbfRbCbfbFCffSMCFHFSfBBCFMbCMRSFBfFbbF#
#CMHfSbHHHFRFCBMFBHHRHSBBfMRSSSFbHfMffFFBRSHCfHfBCRbBBRfCfHBRbSbRbHFBMpSCHFMMbHFBbBBHfSfRSSSSCbCBMb#
#BfBBHHFHMSfHbMCHMFBRMSFFCSRBHHfHCCFfFbCCfbHFSbBMCFRHffCSHHMFFbbMRBHFCCCRbCSbFbFfbSCBbfBSCffRCHFCCb#
#MMffSbFHMRHFRfBSRSCBRbMbbMfbfbFfMBBCfMSMRCSBHfMfHFbRFbBBSFfRMCCbfMSSMMBbHFRSCbHRHSfMbHbCBHFCSfCBHS#
#bBMbSCRSBCRCMSHBSBMRCMBMMbCCCFbCMHRMRRFBHbfCfFBbRFRFFFRSMbfHfMSSMMfHbBHbBSbHFRRRbCRfFFFMRfSRFRMHRR#
#SCbbCHBHBFMCfHbSBffBSCRMBFSRHHCfbBfRBFBCbMBFSRBbBSMFHCFSfbHFBMbBbRBBRFMFbFBBfSCFFfSbHFSFfRfCMHHHMB#
#fMCSCFfMBSfbRBbCFMCBCHfCSMHSRSCFfBRCSSbHRFfCfMHCRMHBHMBbHBCFRMFbMbRFMRbRFCSFBHbBFHFHRCbFbRBCHRHSFf#
#FBCFfMMCbFHMCMbRFSbMbFBCRRbCFHSMHFSHFfFCHCBbHMffRBBfRfFFRCBFBMMRfbHRbbfRMCffSCSBCHfFHbBBRMSSSfFbMF#
#fHHBCCHfRRSSBFFbHFSMBHfbMRCfMRMfMRbCBbbbBFSRRfBMFSFCMMHSfHHMbHRCHSCCbRbSFbHHFMfFbCSbMCbffCbRBSBfHF#
#MMbCFMMBRFRCbfCMfSFSCBCBSMBBHMRMSHCSbHHCFSHbbBCRfMCbSBFFCHHFbFMCSSRSBMbMMbFMRbFRCRFCFSCSFFCHHSHBCB#
#CBbFfCBRCBSRRBMHfFCHBHSHHSHfRbbHfbHRfMHFFMSHMbMBCSBHMFbMMMfFBRMCSRRRbFHSFFMBbMbbFHfCMCRbbRRSfHBbHS#
#bMfBCSBCFfSbbCRCRMMbCCBHSMCfHRFMMMHBfbbMFCbbMfbFCCfbFbfSSRHBbbMFMSRSffBCRBBRfMbbFSMHCHMCRfRHHBCHMR#
#HFfCMfRBBFBHRHfSBRfFffbFHHHSFFMMCFSFRfbHHHfCMbCFFMHbRSfFbbMRSRFfSCMHfFbRMCBHMfHMRHBBCCSFBSHSfbFbHH#
#SRMMRCBFMMCbfFSRBMSRMfBBRbCMRCBBFSBRRRMMfCFCCSbBCFFCSHfCSHRCRHMBHRFFfFfBBCHBFfBRSRCBFCFHMSHRSMCHMf#
#fFFFBBHbFRSBfSbSSMfBbHSFbCMCBfFCffCFFfFFBbBRMRCffSFRSfMMfHCHfHMbbSfFSbMBbHbRMFfHMfMFbRSSBFSfHFFCHB#
#fMHHFSRRBMFSCbBRHHRBCMbBRBFBSFFbMfHHCMbbBbBSSBHRRMbHMfHBBBCHRSSBMHSSRFffMCfSBMCHRBbFfMfMCFbSCbSRMM#
#SbbCCfFCHHRMFHfRRBHBfBCfBFSBbMRMRbfMCHFbFFCBfMbBRCRMffHRCbRBSCRHSMBMffSFMfMbbFffMCbfCMCBfFbRfbSbSb#
#SFHMfMSBBbSBCCRbBCCMMbCSbMFMCMFMMMSBCHRMCFBCbSMfRfSCRMCCfffSMBbHFffbfHbBfMMbfBRSSCfFMFSfbFbRMRRSSC#
#HSSbHRMCBBCbbHfMRFBFFBMRFRSffRfBCbfSCRfBfbHRMfFbFHCRCMbBfBbBCFfSbFHbBCFMFffffFfRBHfFHbffHSfCSBRCRF#
#SMSMSHfBSCSfRbBSCfbCBRFfFbSMfbHHbMFCMfbBMBffHFSbSfCbRMFfBFRCBRHbHbHHBHHFCRHFMRbHRBBSMCfCMFRCCMMfHB#
#HCCBRFfRRCbMbBHFbMRHSSFCbFfCRbCFRFffRHBfCffBSRMSfRfHbCCCbRBBfFfbRCfSFMFMHFRRMMRfRCHRbffbMFbRRSbbCM#
#MBfMRfSRSbFFfMRMfbRbBbBHRMSRfSFbBMCfbfRFCRbbMfbfMbRbbbSBCfFCFRBFCRHHbHBSCFRRRbSHSHBBMSfCHMHBRCSSBM#
#bFRHMCBHFCbFCRbbBHFCCSbSbRFSFRRfFSBHHbfFRCBHCSMRbSHFfSBRbFFCFRbMCMMBMSSSRBFbHBCSCHSRMCRbBCMFRCMFfM#
#BHbMMBbBHSCMFBbbfRHCCBCbSBFBMCMbFSHMbCfbCRMFHHbBHRBHSRBFMSFbRBSCfbbBCfSSCRSBfFFRFHHBCFBRfbbfCfFCBB#
#HfHfFRHSSHbbbRSCMFbfbCbRHCbbBCSMbRBCFMfCCHfbHbSCHbBSCBHRSfbRFBBRRbBCFCfCHbFSSFFbFRFRfFSCbRbCfbSFRB#
#fBbfFFFBHRMfSBFCCBCffHCRRSHfbBRHRfSCRbBCSSSFFRRFSFCMRbbCfbBbbCBfFHSMRbHRfFSFRfbFCMbRRRMfMbFRFFfCRR#
#CMfSfHfffBCBSCRFBHFRRHbCCSfRfffMRbRRBbHSbbSfHbBFBMRRSSFMFMMBbFRBBfFfMbHMCRFbSRMRHHSMbfRCMMFRfCRSfR#
#SfFRFMSFBBfBFfBMffFbFbRRBHMfFSFSRSBBSCHHbBHRMFHBbFbBHSBfBRRHFHbCHHCBbMfFfMMbMbFfMbbHbMCBSCbRRMSfbf#
#RRSCbMHCBfbCSSHRfSCFRSHHMbRCBMFSBSMfbMHRHFRFHRHBMMfbBHBbMfRbfMFMBSHbMMfSfSSMfHbHRSBfCCCbMHSCbHfFCR#
#BMMBCbFCBFMBFFBfHMBFBFBHHCFSSbSCSfMBHSCbCCHfSbCRSbRbBfSfBfHSBMBfbRfSfRSFCSBHfSfCbfHFSBRHSRFfMRRFMF#
#RbRRSfMfMBFMbMRRHbSfCbbFFCBCSCbRfRHHRMSHSfHfFRSfCMMRFCCFbBFRRBBbFbSRHFFFCFBSMfHMHRSbSHBfMFMbFfMFbf#
#BCfSRHHbSFbHBBbHFRfHMFMbCMBCRMFMbHSBbBSHMHfbRCBCSFfCFSbSFSCCHMMHbMRFHMSCFMFFCSRHbMHCRHRFSHCHCRMHBM#
#bRfFMSCHbbBHbBfBCCMCbbFFBCFMRRMFSRSFBHBFBCBFbBCSFFRSSbfMbBfRMCCBbSMBfHHHbRSMSRbCHfFfbRFBffHHMRSMfF#
#FBCFfBMHBbSHfbCMRHbCfFRSCHbBbMRMBRBMBFMbCfRfBbRMFMRRfbbFRMHFMHBMHCRHbFbMMCbHMFRRMfMCSRRCFSbbCFbMbC#
#RSHSBSSBbHbbbCRBRFBfffFFSCRBCCHFRbMMFHffFBSbRfbFSMHfBMHfCMFCFSRMCCRFHCMHSFSfbCfRHRbfHSBFFbMRBFCfSB#
#RRMCSMRHSFRSCbSMbHSfbMBffSBHfHSMSRRffCfRSCMBRHBFBBCFfHHHMCHSSfHMBSfbFfMFFFRCRBBMBFffRMbbfMHFHRRSFf#
#FFFbMSSRCHCFRCMMfbHHHMRFSCSFSMCMHRFRHfSBFCCHBMbfbFHHSHRSHCBSCFCCHMfbBHFSbSBBHBCCFHHbFRRBCfMbMbCBff#
#SCfSfCHCCSbSHHCFFffbFHHFbbCRBBRCbHHSBRbRfHFbMCMSbHCBfMCFCMbfBffSRFSHSCFMCFRMBCMMfBRBCFFRCFBMHfCCHH#
#fHHMSHHBMfSbMFCSCFRFbCfBbMfbFRFCHRRCCbSfMHRCCCBfCHSHbCFSRFfFBfHFFFbBRFMBMCHSMRHHFHRBMFBHbRbSBfHFbb#
#bHfFbSfMSRbFBbFFBCMFRCMfFBFfHFBCfFFRfFSSSCFBMRSCMBBfSBbRFHMFRHCHMHFFCCHSCMSRbSBRHRSbMSFMSMBSbfHSCH#
#RFMFBCSMfFCCCCSRfMCMCBfbbFMRMfRFFMbFHBffbRHBFCSFFFbCHfBSCSBffCbMfbRfSCCSCfSRSfMMBfHBMRMffbSbbbfSMB#
#MFMSBFHfRBCbbBffSbFfHSSCBbSMMbHRHBFfRBfMbBRHSSHCCCSfFCRfMMBfbMRbfRSFbFbHCHbRbFFMMFfCfSbRMbbfFbSfSB#
#SFSRCSMRMRHSFCSHBFHFfRfMfHfFHMSfMHMFCMRCMBFFFbBHMRRFBHRSSCHMbCBMSMBFHSbbSHSMHSCbSbbMFFFCSFRMRCRSbS#
#HFHFbbbHBBBCMSfSCMSRHHHBHFBbSMFHFHSSbMSBRRfRbMCfRfCMHFHRbHCCFMfSfHffbSCCMCfBBMBHffbbFSFSSHfFBbbbbf#
#fCHSCHFSMFMRbBMHSbMMFbfHBbCffRCRFbbHSMFMbbSMCFMCRSMMMRSMMbCCSMbbfRBHbCHHBffbSRFBMHMffRMfBMSSCRSRRM#
#SBRfCFSMHCCBbFRHRCFRMSBHHHRbFRfBbSHHbBMRHHCCCbbbRMMbHBRMSBBfMfSSFFfMbSRHfSbHFSSbbRRCHfBbBBfMFCHBfR#
#RbRBfbbbMMBCbRbBFFFHMFHfFfHbFMMSfBMBFbRSHRCFHSCfCMHSBRHBCFHfSCHSRRHBbHBMRRfFMBHRFCMFSHFbHffBRSHFFC#
#bHCfHFCCbBSHMBbfbHSHHMRCMFCbRRbSFCFbBFFbRSBMFfRCBRMbRSbBFRFHfCFfCMCHRMCFSHMRbbBbfMbfRFRBbBFCBbbCSF#
#CCMMfRMCFHfCMCFHffSMbCCbBFSRbHBRCBHSHbSRBMRMFFMfBCFbMCRFRCBBMCfRBfCCSfFfSBfFRRMSMMBfMfHfCCRBffBHbS#
#SCHfRMRSRMBMMHRbBbHMHSbRSBMbSHRHMSMSSFSRSHHMfBRMSCBbRRMbRbCbbSRSSMRCCMbMBBMfCSBfBFMMSCFMMRFBHHBSCB#
#fbCfFMfbbSBbMMCMCRBHHCRMCSbMBBSHMSMbBHBfCfRRMFSHbHCCCBCbCfBbbFBMFFCMSfbFFMHbMfFMFBMbMSMHSbSfFHSbRb#
#RSRbFRMRRbMHSFBRBCRSfBSCMSbHHBfMMSMfBHFBCbFHHBMMCbbCRHRRMMFCMHRfFBRBRBfCfSBSCMSfbSSBBRSfHSCfbMSRRf#
#bSBfbCCMCCFCMRRfBCHMSBMbRCSbbbHRbSCHbHHMCCCCHHSFbbHFCRCMSMBCbbBCBRCfMHbFBfbSfbBFHBfbFRRfRCfBRBBFSM#
#bHbHBCCRSfBbBSfFMBMfCfFMMCfFHSMBHBRRBCRCbFMSHCRbBRBBbSRfRCbRbSHRCHRfbbFHFRRSHMHMBRCHHBBCMCBbbbbRRF#
#bfHfBHMRbHfHCFCRfRCRbfFMHBMfBRbHfMSCRSCMbMBRMSFRFFfHRMFbMCSBCHfMbSSBRSBbBRFHCbRFFSFCbfFSHbHCBBMbRH#
#bSBSBCBSBMBMMfFFCfMSHFRRbMHSFbFfbfSHCBSbRRSCfbBfRCSFFHFfbBFMbFfHFFHbHCbbBHFRHbbMSbCSSFBbMRMSFFSMHf#
#CBMFSSBBRHFMRbMMbCCbHFBMbMFFHHSHSHHSHSfBBRMMRBFCBCHfbCMFMBbFSbfbFSFFBCCSSMHSbCbRRFCHHMSRBMCBCBRBMF#
#bbRRCbRMSFSMRfHbHHSbHHbRHRMMfBMHFfBbCbRFRfMFbSSbBBBFMbBRHbHbHSSMMMMCfbSfFBSHBbFfbCfRCbCfFfffffRBHR#
#HCFHCfRSCRbCSfRbBSHFBFCRSHMBffRbfbbfCbfFHMCBHHRRRCMHHRSCBbfMBSHSHCCbRCHMBbMffMBRMMfBSHBfMSHbHfHbfR#
#SbfMbbSFHBFRHRSCffCBbRHRSFMRHRRSCMMfBRMHHSBFfCCMCFCRFRfRfMbfRSBbHMBbbRHFBFCMBCbRRbSRCMBCBfFFSSfbMM#
#FFHBMbCMfBFRHCbRRMCfRMbfbBBMCBBFBMFRFHRbRSfHSfCffHFFCffSRRMfFMBMSBMMSBfFSBBRFRRFRHCFHRfHSHFSSMCfCS#
#CHbMBBBHCbCMfMRbbSMHFBFFMRMfCfFBSHFHFSfSCHRRfMMFHFHSSSRfCRfRFCFbBBCfBCBSBHMbbRHbSFCfCSCfbFfHbRSfFB#
#RHFHbSMMBBHMfSBHCbMCbMFBMMMbbFHSbBRMRBRMSBMHCHSBMfMffFbFHHCMFCBRbHbRMSHMbCCSbbCMHfSfRbRfFHFFRRfFbF#
#RRCHBFBbRbFbRHfFCbBCHfHFFCFbHFMbCFMFBSFbRFSBFfBFFFSRMSCHCCfHCSSBfRMBfBCCRSRfMFHRfbBMRRMMMCCCRbFfCM#
#fCRMRHCffFBHbSCFHfHCSRHRfSHHBBfFfCBfMfCSSHBbRbCSSbHbRSbRFHHMSHBfSHbSSCfbCSBFfRBMHFFMMfHbbBHMCbHMMF#
#CRMCSfCbbfFfFFRCFBBFHSHMbCbSCFbCCRBfSSBBfMBSMMRfSHRMfbCMMSBMbHffMCSfSHHHFCFCRMSCHbBBfSFfCCfMRfbRbM#
#bBCSCRFMbSHRBBSFHfHFFFBbfSbbbfRFFBFbHRSfRBCfbCSCHBHHCHfbMbHCfSbCfMfFFRbfCCFfRbfMRbFfSCBHBHCFFfSBRB#
#CFSbCSSbbFHHfSCBfbMfbHHMSRCRCRfBfRCSbSRCbMBCBSBMbMHbBbRHBCBRCfbbMBRRHSFRbbMRFCFMBHBbSBBFCbBbSMbBSS#
#FSbHFRBCfbbSFMMBSbSMRSffHCHMbMMSHfBMRMbRfSMFBMbBRfSBMRRSSffBRCFBMbHBBfCHbRRMHBSBHHbSCMfbSbSMbRMbCS#
#MBMSBMCbFbbMFRFSSMBSbSBbFSMHRCHHSCRRMSFHCHBfMFFHFMSCffHCCMRfbMSbfSMBCFBFCfBCSSHRbfCSCBBBfHCHbbCbSB#
#FfBbBBHRBfBFbCCCHfSHSSBBHFbHHSFbSFfRFbMHfRBCHHCBFCFRCHbBCSBFbBFCBFfBFfHSfBfbSBMBfCCCHbbSfMHbRRFMMf#
#BMMHBBfFSbHHSHbFbFHfSMbFBMMHFMbHSfBFFFBFffMMFMRFHCSFHMRBMfffCSCfSMbHCfbBCRFffBCffbMSBbFHRHHfHfSHRB#
#CHHCMBSRSbCRBBfRBbBfCMCSMMbMFCFBFFCCBbfCfHMfMRMRHCSBCfbbbMHBSMffBFBfRBRMFHFMRHBRSHbbSbFSBSfHMMbFHf#
#CfHfHfCRRMRMMCBbRFbFFfRMRBbMFHRBbbSBCHHbfFSMHfRCfRBFSCBRRMfRHCfFbCRbBCMHRbBCMHFHBSMbfHHCMHCHRBBCHM#
#RFFMFHMbMSFMCFCRSfRMCHfFHCCHbMSSBSBCFSRBCffFHBBBBbfFMHFRBMfBCCbRHbMSHMMRfFbCbRBRBbSRbFMCHfFSMCFSRS#
#bFHBMFRCSHbFSHSSSRSRBHMRRMMCRSfRFfbFBSfCBRCHCSHSfCSMbBRbfMFMfCbHbRMCRRMSMCFSBRbRBfSFMHRCbfRBbMBFMM#
#MBMMFfBfCCBFfCBBHSCSFHCHCCFfbHCCbBfRSbRRSHSSMMCSMHRbSHCHMCSBCSHBbfFFbfHMbbFFSHFHFRHCSCBFHbCBRHFSRb#
####################################################################################################
