####################################################################################################
#HRSSHHMbCRFSffbCRbSFFfbFBSHHMffFfRMCbFSRVSSVSRRfRCVFHFFfHMSSSRRBHFBVFSMBMFSRVMRBSbCCMVBCMCMFFFBSHF#
#MCCHCMRMFMMVBSBRRSFHCRHRSBSbFfMFFRMMMVRRRMfBfBFRfCCBbHHSSRVMRVHbbVBHRVVfVBVbVRbBBHCRVVRCFHHCCBBHHH#
#HHFFSHFFVbCbfCCfbHRBHbFBBBMHMFSbSfVMMHSSbHRSVfFbSBHHSRMHFVFVFFMFfVFRVFVBSVMBRMfSVBMfVbVCMbFCSbFRbM#
#fVCfBHSVRVfCVBVFFRRMBFSfBbHSbRRbCHMRMBBMFMBHMMSbHMVbVfbfVfCfRVHBFfCRHMBfFFCBSVRfHRRBCMCVBHMfMMFCFM#
#bBSfFVFMFFHMMHVMFCbMMMBbVfRbMMCHBbbCCSVBMfVSMVCRbMMbVSCBFVRBHBHBRCRSFVMFSRFFBSbFBSBbCVFBRRSSVFfHHB#
#SfCMRbHBHMMVBMVCfBMFRFCRVSfVCSRSVCVFRBSbSCRSSMBSRBVHCCMSfbSCSSFfSSVHVRfBMffMRRMBBfMSffFHFSVbbbRRBC#
#RFMCCFfCHfSbfCHVHVbbCVfffCFRBfMbCHRRBSbbbfCMMMbbCbffRHCfSHRbSCRbBbVBHBMRCfMRBMSRCFCVCbFHfRMRHMBbRS#
#FBSHbHHFBMCBHfVBCbBRVbMCBRMSBVRBMHVVHVBSBCFVbCFSFffSFHMSfHHRHSRCVMFCRBSMHBCBSVSMSHfFfRHSFVCVHSfVBb#
#SRVBBbRbHVBCRRFVHCbfBMfVVFSfRMCRSBRHfVbCMffRfBfBSMSHbFRRRBMfSMHHHBfMSSVbRBBFbRHHRBfbHSRHCCHBHfMRRV#
#FMHHRVMSSfVFfMSBRVSbRFCRCMfSHVRFbbMbFCbHCMHSHCFSbfRMbHCfMCRbMMFHVVHVfMCHBRSVFbSRCBfHHBfCBCRBbMVMfF#
#VCRVVHCFVSHFHRBCVbMVfCFSBSFRCRMfHSSFVFbfHbSFVfRFCSbMFfCbBCSSSSSMVVfBCCRCbFHCFfMMMCRMFHSFfHVFSMRBfF#
#CFCCHCFFSSCHbVVSMMRFfFFSMHHRVfbFSHBHMFSVVFMBbVCCFVfRBbCBRbSMRHfBCFSBHSbBFFBbfMMffCRMSMVfCbHCBfbSBR#
#FBFSBffVfFSRCbVHMbBfHfHCCVRFCCCfHHffCFbVFFBFSBVRHHCRbMSfCBCFBCFRVCMFBbVMbMfBSbbSMMMRFSFHMbFMfCCfMb#
#bMbMMFCMRfBCbBfFHRRbSbCVCbBbMSFCffCFSBBHMCFCVFRMfRCMMBbFRRRVSfHbBHSHVCHVCHFSSFFRbBFFRbMFFSfMbSHFMf#
#bHHfbHHSBRRBBFSVfMVRSMFBVHRRbFBSBCMHBFbSRSSRMfVFMSbMbBSVCBfCMRfCBRRCfHSVCVBbSRCBbbfFBMCfbfSRBfBSbB#
#CMRBMHRFbHHbfHMbBHfbHMBRCbRRMMRBBHBMHHFfSCFSMCSBVFVFRbBVbRbCSMVVfSVfRCFMFfBFVVHFRSRHMBHSRFBRSMbCMR#
#RSMVfFfRfCCbFSMFMRFVHfCCRFfbHfbMVfVRBFRfVSMVRFfVSSHBffRVbBCfVfHMSBSHVSFFBfVfbCFRfSVRRSRMfVbRSFVMBH#
#RBMBHCSbHSSbRHMRCBfFbCHCRfbSRbSBVRbSfMffBHFFRCbVFFMHHBSBCSCHCMVCbfBHRVbBMHHfBRBCfVRVfHfVfRVbHVRHHM#
#fVFBHVHBCRbbCfMbRSHSRfffCMbSbMBSSVRfSfVMHBSVRCCfFBVfRHFHVbSVCFVVVRFbVSVCVfCBMbVbMMRFSMSMBCHRSBVRMM#
#ffCSbbRMFbFbCRBSFCVVRVfBbfHVCFBFHbSRRMRSMFVCVbFFVbBSFRHMBMRffVFHMBRHRCSRVHVSRCRCBVFfRFMVRMFCSFfbfR#
#CVMMBSRfVRRbCMHffRVBMBfMHRfFMBMCfFCBBBHSFMfSBMbFbBbbHMHBCSSfVVHVCFCMFFCSBRMFbVRFMFHRVVSCSFfSHfBbRM#
#CSMSRFbFHHFfRCHHRSBHBCFfHFbVHFRFMfHVMHCBfHMbbHRHRBbFRSVHCMFCRHBCCBHVCCbMSRRHSfVBHMBHBSBBBRRVVSVSBB#
#FCBbFRRVFSFSbbRFCBfRfHHBMHfHRVHSHfHHRffbSfFSRFVMHbfMSfVRVHSHVFRHCMCFFBRSMRBCVffHMMbfHBbMMBCBVBBfHF#
#VRFBRFVHBfFfHRBSfVbSVMbCbVCFHSbfBFMMVbRMSFfHBbbfMHfCFCfRHRMMbBFMbbFbRSFHHMFVHBbfSSCBfHfbFbFfBSHHCC#
#CSVbSfRfCFBbVRHVFFHMHHHFVMSSHMVBSfSbCSfRFRHfVBRFVVBMVbCRSfVRMRSbBRMSFbSCfHRFBRFFVHbMbBRfMHBHbBHbfM#
#FCVRMMHCbRfCbRBMfRBRCSbSfCFSBMSbMCRMHCRBSMVFHSbBRHBHbRRBbRSbVCFbBCfbRbVFMCFRFCfHRSBMHBbSbVSSFbFMSH#
#RMVHfVHVHHbbBfMbCfFCBfMHHCMVRVCMMBRVfMCfSVCCSRbCffbMHCFSFSffBFCfbVffBBCBfMVRMfBFCVRVSfBHBRVRCfSSMf#
#BMVCRFBHVCSFMMbRRCMbCHbbCbfBHRCBfCbRMVRRCFSbSMHfHVCVbbVSMMVfbMVMSRFMfMCMFFSRfMfMFCHfCbbHbRfCCVMHFR#
#CCMbVfCBMfBSSbCVMHSffHHCVVMBSVFFVRBRFHbCBRHRVBFRBbCfMRFCbRFVCBHRBFBBSRRfVfFCMMbBbFCFVMVMfHbVMVSMCB#
#bFHCFBHFCbfRFRVHCSCRfCbRBHHBVCCVHCFRHSSfFMbFffCRVSVCHBMBFRbMFCMBMSRRBMfMHCBCFBbCMFVMVRBVMCfBbBfFVF#
#VVbbRVfMMbCVHRHHRfHHffCRCRVfCRfCBCHSbBCCVbbBCbHVRRRVSbHVRHMMHCSfBfRMSBFVBSFSRHBMbFMHMBCfHfMVSFRCFF#
#SFRHbFCRHVbFHVbfVCVBfCCSMBSfRFSfFVMCFSSfFMBCSBfRbMFFffBMFSbHfCCRHRfRVFCMfbCFbbFBVMCBbFbfCfSHHVBBHC#
#FVBBRFRHHCHMCbBfHfbbHfVRbfbCBHHMbffVbSVRfbMFfCBBFRVbfVbMVfHRffSCSMfRSCSBSCHFVfMHRMVHVFHbRMHVBffSFR#
#SSFVffVFCMRRMFSMHBVMFVfCRbfFbBRSMSBHHSBHFVBbRBCfHVFFMVBHBFVfMVRFSFBFFBCMRMSfHCCMCbbCFMVRBCCRRfMbVH#
#FfSfMFbFCbffHVFBFSHFRBBFCSVMfMVMBSfMBVCMFVSSfMbRVbHMFbCfHFMFCfMBFSHCfSFRHCSRFHHCMFMbHFSFSbHBbRHbVS#
#SRbHbfMSRBCVBRVSCFHbCVRVSSRFFFbBFCHCSBRHHMHRRMCRRfRCfMCFFBVCVRRMRfMBSBfBBMMfHMVfBSFFMBCMCMHVBBVHVC#
#MbHVMFFfRbCMHbHVBHFMFVBMBVFFVBFBHVbRBVVfMCCRVfbSbVfbfSCRMVBRHFbRMfFBRVRfbMbHCBSSCRbSFFbMbVMVHfFSBR#
#SRSFMHVVRVBHRVCbbfMFCfBMCMCVRFRFbbfBfRVHBfFBCRVRFRRSHFRbRHHHbSHFfSMfFSSCSbMFBHVRMFfCbVMSFHHMVMCfFV#
#SbVBBCFbCVSHSBbfBbVMMfffSSHBFHHHRCSFMSbHBFfSfSVRBfMbVfFFCVfbVRfMCBHRSSFRfRfVSfRBHCRSRHHMVHRHHBMHHb#
#RbfVfVSFBVCbHRMFBfHCFMSMFCFSVCVHHRMSfMBVCFMVCRRBBfHMRbCFSfMbVSVCVHFVBHbFBVVBVfBCHMFbFMHRfMHBHSMfbf#
#bFBMbSMbRBfVCRBMSMRMBfFfBVHSSFfHHCVRHHfbVFVBbMHBHBHfVMVbCfMbCHHFRfRMBHCfRVHMVBCVSVBHCbbBBbCCFCMFMM#
#RBbSSVMRMFBRMFSbFMMVHRMCBFMHMMRfCBHHfCCVbbbMVFMHBffRHbbMbCMMMVRCMSMCVBSMfMbfVCHMHMSMBBVFMCRFfSFVRB#
#VBVSSMFRMRHVCSVVbfCVffCVffRFCHHRCRMHFCCFCFSbMCSVSbfCHHVCRBfSBHVFBbBCFRCBFbMBFMSCbMMRVRBCRFRVfRFHBR#
#bMbbMfBRbBffRRCfBfCBVFRbFFMSVMfCFFSfMbBVHfMbRBRfbVMHbfSHMMMCCbCSCVSHRRbfBSCSSHbVCfbfHHVfSBVBVRCBVR#
#HBFbVfRMRbFVMCbMFbbCMfRSRMMMVBSSSSCfSFBMCMSFFCFCbRfRBBCMMFBCBSHSSVCFBVMFfRVCHfHHRbBMfCFbFfbRbHSSVB#
#FBfFVbHSMFBCfFHHBFMVSfCCVVFHbRMbbVCVFSfCbFBRbSMfMVBMFSHSVVMbMfRbFBffSVRSbBVfHHbVbMMMfCVSCCHMMfVSSC#
#SFCCbbfFfbSBBbFCFBVbbVBBfHfVVRfFHHBMVMBBHRRFSBCfHSHVMVFbRSBSffMFBRRHMFVVHbFBSRFMfFSpfMCVSHSRHSVHHB#
#BVFRfHFSBMMFRBbfMfMRfVBHBBBBCMHSbRMBVBbHSHfVBSRHHMffRBVFCMFfBSVMMbBFMFRFCRHCHbffbVCMBSHfbFRRVVbCRS#
#FbCRHFfCSRCRMFMBHMCHbCbFMffVfBfBCBBbbBbHSVbRHVBFfCRfFRSRFbfBfFVCbfMMbSBFfFfVMVSHSVFBbHMbCMMFSCRbHH#
#SFCHCRHBMCSfBbHfbCRVFHRHBVVfBFbVSBHFMbMbCVfHHHfbMMVSfVHVMRCbCVVVSbfRSbBSFMRbVBbffHRMSfMCCHFVBSSfMH#
#fffBVSHFMfHHbMRMCBfbBfSVVfFFCVVCfVBbHCMFFbbRfVBBBVCHRMBFMHSBSRCHSffbFFVfCffFHbBfffRSFSSRVHHfHRMfBf#
#BRFCMfBRVMRFMMfBRFVBBCRHRMCBfMSSVHFfCfVFMVSBbCHSVMbSfFHFSfVbHBbBRfVRCSBMFfbCfbVMbMFMBCSBbBHVRfVSCV#
#BbVVFCbbVRfHVFVVSRHFRRBHSfMCMFMFMSVRHMSfbFVHHHCSFMMSBRbBfRBCCVfMHFBMSSVfCHBVMRSBRVffCbVCHCRFFBCCSH#
#VfCBHMfHCfSVRfBVBBHFfRBfMFRRbVVSSMHCMMbbbBbbRVBCBVRCbRMbHSFHFffVMSHbRVRBFRFSBbFRCfbRMHHVSSCCBBRHfH#
#RHHbSbSbHFMSCRVBbVRHfFMFMffMHCBSFVVMHVCFRHCMHBfBVVMVHVSSBCSMVSCbMHRSVVVRRMRRMfHVRbBHbRfMVfCMRHBCRM#
#RHCFSBCffHBSSCMSSCHFbCBRRbbbSSFfHFbMRCSSVSVfSVFMbHbVBRFRMCMFFSMHbHVBRHBBHFCFCbbHRVVFHbBHVHbHRBbSMC#
#FCRCBVbbHHHFCHbBVCFfFSHBBbBVVCCMfCSMCSVbCMVMHRBFRCfSRRMBbBbSbHbVMCVSCBVMRBMMMfCVRbfRBFbHVFRFFbFCFH#
#MVFBfbCFRBVHCCbbRfVCHHVCBSBVVbbMVBRFfRVVbRbCRCCSHHMSSRRbRMbHHHVfMCVSMRHMfMVBSVHfbSHMbfSbMVRBSRHbVR#
#HCMfRVFHFFCSCMCCHbBbMSBMCSfHHSRCRfFfMSCRHMFMSVCRbBFRCMVBfbFBCBCHVfFFMBRfBMBVCBSRfSfRHSHbfVCHVRVRbH#
#BMfBbMHRSRSSCHFfHVMBBbRfSBHFBCbfHCHCSFRBfHFfFCfVBCVMVHVCbfRCSVfMHfFfffRVRSVMBBCffSfVCRRHMMVBRffCFS#
#HMFfRHbfSbVFFVfSbfBbbVbCFMfSBCSRHFBfBbbRCfHHCCHVfMRCBbSCfRMHHffHVFfCBHMVHVHbCRFHSSVbBBSMRFCBSfSCBV#
#BMMMCRbBBBSbSSSRfSSfCHMFCMBVfffCSBHSVVVHCHMfMRRfMRCSHRSCfBfFSFMSBFCfMRfSFSbHMMFRbFMHbVCBCMbRHfCRVR#
#HMCBMVFHFHCFCVVVCVBMRRVbCRFSBCHBVbSVFVVRHfSRbBBMSCVBHSfFRbFBSMCbSMfHfbbCVFHSBSFHCVHRfCFFfFbBRCMfbf#
#SMFMMbfBRVBRFbSSfCfFCbCMSbbbVbBBCSVBMMSVbMSRVFbHfRSFVMSFFBVSMVCBMRfRCHVfMFSHbbbbRHBSbHfFSMHVVCMFbb#
#FMBHBbMSRCRCCfFbFMVbVHMMFfSFHbHbFbVRVFVfCSHfbHfSSHSVfbBCFHHRSHBfbfCbRHCRVVBVHFVBCfCbMSHfBRVMSRCCfC#
#HfbSbMHMRVFbHFMMFSHHVVRCMVCRFbMFbbSMRHBfRRHfHMSfFRfFMVBCFRCFbSSfVMSbMbRSFCCbbCbSHbHSVSHRMMRRbCRSfF#
#MMRFRFVRVMVMVFVbMMRFCHBCMSHMfBbHVMFSbMVHCMCffSHVfSCVCSSBFSFMffFfFMSVCFHCFHFSFfbMbMFfBFfCHRbVFVbMBS#
#MCHHbHSVHbFCMHCBRfCMBCFHfVCBVHMRBSbMVBFfBfSHFBVRHMRSCBRRRfBSMCRbCVBBBHbRfBbbCHbfVMFbbRRVSfCbRCBfHf#
#VVFFCBSBVCHbMbVSbRHVHBBffMSMVRFFRBCVBCMHBHFVFRFbfRSMSSfSVVCRMSVHFCCRSMFHMVSHCMBVSBSBHBFVBFffRCSHBV#
#MFHbffbfHfSRfFVbSMMFRRCFSFCCfVHBSRCBCVMRCCffSHMHVSSBMHFRRfbFbFfBfFMMSFVSSCfVHFHMbbRRFFMVSSHbFHMRFS#
#VHVBVRHVfHbBbCSMCfRBRfHMRHVSRMSbVbBfBCbHRMVfCCfSfFHbSRFffFHVHfVVBRbCVBBCBMBfRRCHSffFfBFbSCbRVCbBBb#
#MSRHbHVHbCBMHMfHRHFRbHSSSbCbHSFHMbRMFCCbHCRBSRHbFCRVFVfSfRFbFCCBbbVSbBHbMbSVRVBMSSCHVMbMBVMFFSbHHV#
#MfFRHVHVRFfVVVCSVFfbfFSHFRfHCfVRFfRCVbbMMHBSCFVCfFfBMBSRMCCFfffFVRBFfBFBBFVMRHSHVMRCBFHRHSSRHFMfFR#
#CSHHFCBVVBCVbBVCMVBMHRfSffHBRBVBSCRVFbSBHfFRRMMRRfCHSVSBSVSVBfHSSMVBbFHMMBMfMHMfBHfBMFFCfBBbRRfVHH#
#ffCCBMHSfBffSCCbRVRBfFVCMFVBffVHCVHfFHfHMHMHMFSBRCVMHHVSbFFCSSRVRbMMVVBVSbSbHSRRBCfRRBBbffCMRHRMbf#
#HMMFbVBFSCFfCBfVFHHHVVVMFfffMFFRfHfVRfFBbbbHBbRVCbRVMCHMbBCRHbHbBSRHSBBFbSfBfCVRVCfCCCbbRbFMHMMRFF#
#RSCMMFCHVCfSfbHfRCVfVFVMVMBCRFfHSCVfMbRVBSfRSBfFfbRCFMCBbFVBBCFHCbRfBSBMVSFfRbbfSSCbSfBRCRVRFFFBSB#
#CMSBFMCFVBfffVHMFRRMfRMFfHSHbbCVBBHfRfSHFVfBVSFSVVFVFfSSHHffFRFHSCFVfHSSBHFRRVFCSbHVfRbCCBMVHHMfff#
#SbVRSSVBMSMFfSRBbHRCVRMfVRbfBSFFbCRbBbfVRRSMfBCVCRMCbHVRRHRfRfRBSVBMRbRVVRFHHfffSbFSfCMHfSbRRMVHRC#
#SMfRRbBbRSfbMMffCbMVBRCRVVfRVHVRBMFFRVBFSbBMbMSfMfRRCHMCRRFFHbMbSRfHVCBMSCCFBHBSHVHHCFFbfCMfCFBRbF#
#MCCMMFHFVCCSBRBCbFHRHMBfBSFSFRFBVVbBfFBBbSVBbMHfCfBbbSMFVbRMCSMFSSRFRFCMCMBSfRbFCSMbBbbHSRMHSFSbBF#
#SHRHbFbCbFRRfVFSbFCBSHfMRbCSRSMfFVFHCCMRCbRHVRBVBCHRCBbCSRRVBBCFbbfMMVbCRBVVbMSCffbMBBHSMBSfVBfRbS#
#ffRbCVbSVHFbVFMHbCRRBCbHVMSHMHBRFfCHVCfRMRFVVRbFbbMSHFFVfMBBbffMFfMHRRVBbBHHCVRbSRfBVMHHMbHBfVBMVB#
#BMSMVbVfBRMSCfHRCBHFHbFVMHRVbSBMHMbfHSVCbMRBFFbbFHCFMRSRVRCHfRBbSVRSRBfCFFHMBVHCFSBSMRCRfbSVVfHMBR#
#VBfHfCVSSBfbfRRRHFCSMSbHFMVHSVHHfbBVRFFfHHbSHCbSHCHVRbfCFVCbMbbRRFRRVHBfHfBSFbRVBHVBHbVBRMbHMCMbfb#
#CfCVRbMbCHHbfFBRRBMRRHfHBBMBbHbSBCHSHMRHfSSfMSfRfbMFVMBFCBVRMMBCHBSCCRfSVfMfBbSbbHMHBBVBFRFHFVFBSR#
#fVBCMMSVfMffSCCHSCbSSRVVRbbCMHMfbRbSHMVbfHCFFCRHMSMFFbMCRRfBCHCVRRFMFHCfRHSSFRBFBbCVSSVVBfBbRMRCMC#
#VSfFMMFVfCVMCCVfSMHMbRSHVFbbBRBbSbFSCCSRfVMRSbCRFBRfBHCFVCFHbHCbRSFCFfVVHVFRFCBFHHCfCRbMbBHCFVFSFM#
#fSCFCfbMMVfMfCFRVRfFbMHFHHCFRVFSSMRVMFbCRCbRBBSHFCMMbBfVbCFBfRCRFbfMSFFSCMbVfBSfMBFCRfBHSSfRCMFVRH#
#RfRMHFCfBRBVRRSfRVMHVBMSSBRMVVHHVfMMbffBFSfSfMHbFHBFCFFSfSFRCbSbMCfMRCbSfVFCBRVCHRCFFMCCFfRRFffFFR#
#fRRCFbBfSbfHVCCBfFbCVfSffVVRfCMCFfMRbCSbFbfCBfVHCRSBHHHbVVVbfFbRBBHHMRSbFFVRCHBRVfVCfCSFBFRRVFCFfb#
#CfMFSCfbBSCffRbRBbbSfBbSfbCRfHffbMFSCMSMFRVRbHCfbVMFCVFVCRbCCSFFSfRCMfSMbCCBfbFVVSfRfVbbfHRMSBCfMV#
#SHVFCfBfSbVCVSfRRMMBFMCRFHVMHFbSVFSfRHVMCVFCfSVRSVHMbHMRHHBHRRSFHFVBMFffCHBFBRbFbRbCffHSMVMFVSBbbB#
#MbHbFFbCFSCffFRVCRbMVRSVfSFMHFbFFFBBSbRfVbHHMRBbbRFVfVFMSBFMBFVSCRBVRVRCCHBVfMVfSSVfMfHBSBFbMbHfFB#
#HRBHHCSFMRCBFSFfRBRHSHfCHFRHFfBMCbbbFHfHBRfRCRfFMSfBFCFbbCfHMMCMBSSBfVSSMVRVCRfHfSBRCRBRFfbRSfHfVF#
#RFbRMMfCFMbMbbHbCVRFBBbBRRSSVCFMRFBMRBFfSFBSbBCBCRCHFRCfbMMFMFfFbFBFMCFHFRfMBfbHFfHHBBBBBCMfMVSMVH#
#HHMBVFfBCffRMSFFfFbMRHMMfCMHHSBVHSRFVVVRCHbVFbBCVFVMfSSSfCbRCfbCbSBSSRfRbHCMCMRCFBbSSHFRSVMSVMHbbF#
#fRfVfHRBbFVSHFSCbVffVMFBCVSbVSMMMHSFBVfSFSSMSVVVRMVCVbHbMRVfSVBBCCMbMMMRFRRfHbCSBbBVRbSSRVMCMFbVRH#
####################################################################################################
