####################################################################################################
#FRfCCRMfSfHfRRMfCHfRFFMRCbCCHbBHFMFbBCFCbSRCSfSfCfSCHSBbCFCCRFMCCSSBFCRfbCMRCHfRBBBCMSCFMMCSMCCCBf#
#CRCfffBHbRRRMBFBBBHSHHBfBMRSFRMMRfMbRfRMBbfbBFMFCBbFHCfbbMRFCBMbffRbCFMBbHMBCbHFRCRbBHfHCMFfMHbbCR#
#CBfFbMRHBRHHbCBBFRBRFbbHfFbMFBSBCbSCRSMHbfSfSCSbMbBHSCRbMMSMRfFSbMRRCRbCFMMBMRfMSBfCffRSHHfBBBfFSb#
#SFbCBFCfHfMMCFRFBMHMBffBCCfCFfCFCRbMRBBSHbbffSbBHCHBMMFRRFSCfRFFfHMBMCbCRSRSCFSffBbBFMMMbbbRfMfffF#
#CbMCSfbMRRBCSSFBFfBSMCbCMRCFfRSSbCSSFMSRFCFCRRFHRfFFfFFBFFfRRfRFRfbfCMfBBRSCCSFCMSCCbMBBSSFRRCbbCR#
#MBHMRfbFbFMfSCRMSMSfCMCRMHBfSMbBBFMSHCbSfBFfHRMfCHRHCfSMHCSHBMbRBMFCFCCBMBHSSCfHfFFfBSfbHBSfMBSBbC#
#fHHBHSbBRCbSbMHHCBFHBHFHFMSbBMCSSfHffMbMMbCFMCMBHFbMHFbfSSfBRHHFbMMBRSCSCfRSMBbFBCCHSMbCCSBBBRSRBM#
#CBMRRHfRMCBFbFFfHBSRFFHbBBRbHFMfSHSffbbSSHfBSbRCHRBfRHMFMBffCSMHHbFRBSRSbSbHBFHbRfHfRBBffbffRFfRBS#
#HCCFSBCbBfRBSHBBHfFBRRMMRRCSRBCbMHBMfBCFCbRHFbFBCSSMFBHHMMCHBfCSfFfCMCSCCMRCbCfFbCMFBSSBCfSCFRMCbC#
#fSBfRCMMSBMbBMHfSBFBRHfBbFbCFbHfRCRCFSSBbbffHBfCFFRBSFCCbFbHbCSSFSFRMFBBHbHSffFBCfFbRfMSBbRBFRfMSR#
#MfCRMSFFfHSHMFFSCSFBRHMHSFMfRMbbbSbbMRCBSBCSRHHbCfHBffBSHCCFfSFFBbBMfbBbSbBffCFCBFbHFSbHBRMCCSbRbB#
#HMSMHHCfbfSCffCCSCHbCCBfMCSCRfCfRCfSRFbBFSMCSFCRbMCCSBbfFFbSSHbRFfMCHCFCHSfRSHfBCRMCbBCRBSBfCFbbFC#
#RfHFHHbCRfHRfRCbFSRRFCFCCMBFbfHFRRCMMCCCCSbHfRRCRFfBbFFCCbFSCBRRRMSSSCfBCfCCFFfBfFFfHfBFFMRBfSbbMS#
#SRSFbFSMffMCCHBfSHRRRHbHFHCSbRRMSFRFRCHHSbSSbffHCRCBHHRBRSSRbbBHCFbFHBbSfSCFSMFCfHSRCbRFCfCSBFRFSf#
#FRBHfFMSBMbSfSSHCBbCbCSCHMHFHffMBBbbFFfRHRbCHFBCCRRfFSCFFFbCfFFbBFBfFfbFfCSfCFCfFMHRRRfCRRRFHSfBSR#
#SFRHbCfFSbBBMMCMBBbFRBHffCfMfMSFRMRRHHbMbSRfSSMSFBSfbBHFfMSFRBfFRFCRBFFBMSbMMMRRRCMBMSMbFMMHSRBSbM#
#MCCRFSSfSCSHSHCRRSbHFCRCSRCSCfRbHSRMFHSHRHMHbfbMfSRbbfMBfCSCHRFSRHCRSMFfSffSRbMHMCfbSFSHFBbSMMRFff#
#CMbbHFBBFCSCbBffbbRRBCSRFFCCBFbHRBbbbfbMSRHMSFRMCSFSbCSfbBBSMfbFSfMMbBFRfRHFMbSRFRMfHFBCRCFMFHRSbR#
#BSSHSbCCSRFFCFfCMRRCMbSFHBMCHffSSHFCBMfFMffFHFMFSfbSSbFBHMCFFRbCCHbBBBMFMCBFHCHSfHRMfSBMRFfHfMBbFF#
#bCSFMRSMBCHBbRBHbHMCbFRbbRSRSHRMbRMBbfCSRBffMBFMfCSRFbSRSBBFSCfbSRMCBbMFHRSHBSBSMfFSRRCbMBRCSCHMHf#
#BfRMSBBfSfbRbSHSRfCMRCSBHFCbRBMSSffbMBbBfBRMSBCFRbffMBRfCfSSHHSCSHBBSFbfSHMBfBbSfRRHbbRFCMSSfMbMfC#
#RfBHBCCFHSHbfHMRFMHbRCFCFSSSSBSRFbCHRRbFMRMfMRBbSfFbfSMMHbRBHHMHSbBRMBMfMBCSMCMfFffBSMMSSfSHRbHCBH#
#fCRBRSSBffHbHFfbSFfCfCRCfbfFRMCMbFfRHMBBffHbRCFSBMHbFMHbHbHfHCRbFFFbSMBbFBCMBbCHFSBSMbSbfFSBRFfFbf#
#bMSBHHRbbSMRBBBFbHRCBCHBbSMRRCHHfHbSRbRBHHbCbBHRRHSHBMbbFSHHfbFSfSFbSHbbCFHBCMbRBSHCFFbSHCSFSSFFFF#
#bBMfCCbFMBRBBRbfRRSHRSSffBfSbFCCBSSRbBCSMbCCFHSMFRSbfRFMHFBBfFSHSRMFSCMffCCCSMbFHMSRRCFfCCFFRfCbfF#
#SHHFBMSfBCMCHfbCFBFCSBfBbHRCCMCMBCCHFCfbCFBHFFHbCffHSbRFCRMBfbSCHbCFSRSRfMSSHBBBCSCHRBbMMRMBMCMbHb#
#CMCHbHbCbMMMCFSMMbMBFHfHHFRHffCRMSBSCbBbSRMCfffbFbbFRRMBfCfMMbfMbRSMHCfRBBFBRBbRbfHMbSRHFCCHbBMfFH#
#MfCHSBMBFHfSMRMRfffHBSRMFBHCfCSCSSMMFRffbSRMMFBBRRbbbbSBFSSMfHSRBCfHBRMMMSCMCRbSHbBHfFBHBbFHFSbfRM#
#fRSCSFSRHSfBbRBCMRSFbRRRbCFHCCbbRSMMBHCCfBbMHSFSbbCSBFSRBfMHCHSRSbCbMRRBRMCHCbbSHHBFFHSHRMHHfbfCRB#
#SFBCFBfRbfCHFSRfffFfCfMbMCSfSFRHbFCRbFBSCbBFFCSSBCbBSCCSHSRfCBFRRfFRfbFfFFBMMHBHSMBSHCbfFbfbSfSRFH#
#RfBfFHSRbbBCBCfRFSfbRbMSRRRfHHCRFBBCCMbSHfSMfRMMRRbbMCFbBFFMbHFfBBSHBfbMRFbBFHCHbfffRbCRfbFSMFFHCF#
#SbBMSBHfRCBCSfSHFBHbCHFFFbFfMbSMRFRSHMfRSfbCCMSHHMHSHRFCMffRBbMCFBfBfSBHFRSMRSFRMfHCCbRRCFHBMSSfMC#
#bFRSFCRHfBCfMFRbFSfMMRFBFHCfHHCMSRBfCFSFFbbSBfBMSSSRRMfHfbfCRHCBffBbRCBFbMbCHSSFBFFHMBCHbMSMFSFSbM#
#CffbSSCRbBfbfbRbCBMBBHMHfRfCRbRMMCCSCMHMFMRHFRCCMMCCbHRSFHMHbfCFFbBfRFRRBBCBMMfHMHfBHFFbHbfMRbffbf#
#ffRHRMFfMbfMCRMbbMMMMBCMRSCMSFHfRfBfCCSFBRFRFHCbfBMSCCRFFHbHfbFMRMBHbCFSHfCCfMFBCRMHMCBbFCSHSCffCf#
#CSCfSCbFFFHFSCFbFFMFfFfFSBFMFFbbSFBRHSMBSfBHbHbBfCCBRbHbMHSffbSBCSbRbMRMHbFSCHbFRSSBSBHRHSbBMbHBHb#
#BHRbSfRFFfHBbHCMSFSMMRMFBBRHMBbHFSMHBRCCSBSHHBFFFBRHbCCFbBRRHFCCBCCSMBHHMMCMSBMSbfMFFMfRbfRHCFMSCC#
#BMRSffHFCFCBFMCBbSBHRMfHHbFSMRCHbfMBBRHbMBSBCBbHbSFBfRbHBfCFbSMHffffffFHHRCbSFHHfRHMRBMfFFMHFSFSBf#
#BSHFFbCbfMBRbFFBHHfHHCBMRFMfCBRfFSMbSBHMRRbBHRFFSBfCRHSbRFRBbCHSRMBbMbCMfbHbBFRSHHFBMfBHSffMffHbBC#
#FSHfBFfMHBRHCfSFfCFFFHMfffRHRMFMMBBRRFSFHMfFMRHRMFHSCfBMCRRfSRRCBfBfFbSfbSCFBCbCBMMBfCfbffHMHFRfbB#
#CCCBCRSBSBbHbbMMRbbfBfFFSFbMCfFHSCRCCRCRSCHRbFBHbSBFFBCfMRMRCFMRSHSMSHfbSRFFSBfBHbRfHRSSRMFHMffMbF#
#bCRfBSMHfbBbHRfRbBFbBBBfHFCbCRfBMSSfBfFRCSBHFfMfSSCCRSSSCCBRFMFMSfHRHHHBCbSSHHBCRCbSfCCfSHMCHSMMRB#
#bMSRMRCFfBCMHHbMFFHbCMRBRbbMCCHBMfbCMCMBSHfBMRSbSSRHMfCRbbFSHHMRBCSfSRBMFHHHbSSRMMRFCMbRMHSRFCHFFb#
#FSMffSbSHSBHMRbHCRBSCBfSbRSHSSBBMCfCSfBFMbffFBbHMMFFBRSfRHRRHCMHMMMMFRCBRBBRSRSFMSCMRHSRSSBRFfRbHF#
#HRBBSCbMHfFFCSBbSfCMbFfCCbFBSfMSCfSBMHHbRCfMMbbBMMMRRMFBBBRbBRBBBMFMbFbMRfbHfBFMHCRSBRCFFHbMRCfHSb#
#RRbBfCBFRMHRMfbBCHFCSFFFHBbFBRfMMHBMFRMBFFRSfBbfBbSSHRBfMBMfSSCCHCSMBCFFCfBMCSfBFFHMBfBRHBbHSSMCFH#
#HSFbSCHRMFfSRHRRCRMMbffbSbBHCRBMBCCMHbFCFMCbCfRMMSfBBCMCBfSbfMRBSBMFfSRHCCHbHMCfFfMbHBMCfMHRHbSFfb#
#CfMMMfCFCCHbSfMCFBfBSSBCRMRSSSbCFRRRSHCCFCbSMCCFSfBfFbCMBCFfSSMRHRbBbfFbSBffCbBfFHfbbHfRCfffCHFMRb#
#MMHRBRHbbFHMMfFHFMMMfMRFHRMCRBCFBffBfHSCbMbBbRRHbfbFCBfHFMFCCfCMFRFffHMfFRMHBSMSbFFbFFMffHbMFbRMHC#
#RRRHFMMfRCCMMfRfSCbRSSBfCCfbBFFCCSRBFMBBBSfBCfMFSHMHfSfbRfbMSBMCCFSRMBFfRbFSHSffCbFfCHbFffHSbMHCfF#
#BBfCCRfMHMFCCRCfMRCBRHSfHHMfHRfSfMCSFbbMBRBRCCCMBSCSBfSCSBSCFMSCBbSFRfRRSfBfHCFFfCRbBHCHRMCBBbBRbf#
#HbCRfRbHRMHFMbRffSMfSSMHCMSMFRRFSBBRBMRMCRHRRFSFHMSfCfFFfSRbCCMCSMMRBFSMFRBCfSRSCSbMBFRHRHCSBfBSSb#
#HMHSRBBbFCSRHSSBbMfFMffRHSMCRRRHbbFHHfRSFBfFMSRHSCMfbbHSRFHMCSFCbMFFFSHfMRFSRMHSHffRMCSSHbSSFFbRMB#
#RCBFfRCBBMFbbRbHSBHFFMbHMSMBfHSCCCFRfMBSbHMRfFHRMBfSFMFBRMHBRFBRCCbHbbCSFbMbRfBfCbbbHSFMSFbMfRBFfF#
#FBCHSffBBCCBFSRFMSMMFfbMbSbCfSbBMbSHCfRBRbHCHCbCSRBRfCbMbbHSMfSFFCbCHFbbFMCRMfbBMSFFMbFRRBfbbbSFCS#
#bSFBRbMFHCBFSSffBSHCCCfHMRBBBSbbFbCbRFBbMBCRFMMRFCMfRFBCFMMCSMBSbffbbCMCRbFSCHSFHBMBfFMBBBFFFSBBFM#
#HRfHfbFMFbfMBSCMbHCSBSHRbbHbSFFHfBHfCffHBbfSFffFRbSMFFfFCbbSbCHHbfBfbCbMRHfSfbFHBCHMMHMHHbfBBHHRFC#
#BHbSbfbHbbbFMSSfBBSHFSFfBRbBRBHBBfHHMHFMbHbRBbCfbSfFFbFRbSRSCFRbBHbCMSMMRFRSfCbCbFfFRHMffFFFBCHMbM#
#MBSfHMBFSMBRHHCFFCFfRCMMCRCCMSFSBRSCRRRMCffbFHSbfbbMBSFRMRRMSBSRfFMHMSFMBMSbMMRfFSHRbbBSfSBCbMRMSR#
#CbBMFCFfMbfffHRfbMSCBMCCCbCSHBfFCMCCFHSFSFfSbfMHfMCMBHSRBbRHFCbRMBBHRSHSSBBfbfbBSSbbfMHbSRBfBFMSFC#
#ffMCbCBRCFFFBSCRBfSfFfSBbMMFFBHHbMFFbFMCBFFCCHBHbCfMBffFCbbHbMCMBFHBCFSCRBBHMffRMFbFRSFfbRFBCfCHBM#
#SFHBCSFRbBffFRFBMBSbMbHffbRBCCBCBRRHbCSHFfRCBCSbfbSSSSMbRbCFBSCMBMMSBRbHBMbBfHbSRBfFRFMBRCbbHCbMRH#
#MbHCFRBbbbMBfbMMfSCFBFMCFMbfRbMfSMRFHSbBFRRRFRBRRBSSMSRbSFCFCBMMFHBSfHfCHFfbfHffSfHfBCCFSSCfHRfBbH#
#RRMRMBMMCCSBfSSFCMSCCCBCBHSCRSCfBHbMSHHMSBFfMRBHCRbBSMCHBFSHRRfMSCFbFfBRFCCbRRRFHSCSSBCRfMRbFBbBBF#
#SfRbBSCbBRRbHMRCSbFBSBFMRSRRMMHHCBMbRSBBMBBSCSHRCSBfMRRFfbCRbHCMFFbfMCbHCBBFSCCMMbCHMFfpFCfFFSFFCB#
#BBSCBRMfFCbffbbCbbCHbFMBMFMSFSfCRFMRHBCbSBMbMRFfRFRFCBfMBfHbRFfFHCbFfMfMBHFfHRCfHBFHFCfMfSCFfBfSfM#
#bRBbBFHFHHMfMMbFSCFBHCFFbCCCCBBFMBSFRfHbfRMHRRHSSMMRffHSRRbFFfBbBHSFRSBRfbFCHSMHCbHHFMfBbHHMSfHHCH#
#FHRHMfFBbSBMHCCSFSbHSfMHHMSBCCHMCSMbFBSSHRRCSFRMBHBFRRHCRHMSSbFRSbCFRfbFfBRfFbFfMFSbfbHRbbFMCCCRHM#
#CBBCCCBMHCBbCffFSRBRBBMBBbBSHSMbCSbRBSBfCfBMbCbMHSBMbHMSbfRBHbBHFCfSMMFCHbbBfbSfMRfSSbCRbRCbbCRBbC#
#CFRMfSCMFMFHSbCbFFHfHbFCRbMHSMSCFFFMBRCSfHFCbfSHffCMSbCBHfHFCbfMBBfCBRCfSBHCFFbHSMfBfSBBffFMCRfMfS#
#SbMHHbSMBBBSFbSfBFFMSbBfHBFFfHFRbSFRMSMBHRBBfFbMfCfCRBbBFRCbBMHRMBFRFfFCSFFBMBfbbFSSMRfCFMCFRSRfRR#
#MFBRRMbRCfBRfBRCMfHbbffbFFRFCbCHCRHRCBbRHbbMSBMBSFbMBFRRRFCFBfBSMFfMfHMFSMRRFBRFRHBMbCCFHMCbCRbCfF#
#HRfSHbMfRMBRbCCbSbbCfBFSBSfCMHSRMSHFSbSFSfFCbbHffffbbHbHfHSHSSBBfbHFRBCCRMCSfCCfMMMbSSBBCFSfHbbfMF#
#MSSFfCHbBCBFSRSfBBCFSBHSHCbMbffHMfFfSRbHBCBBCBffRHSRFRBfFFHMMHCRSfFSBRBbbFFBSSfCffMBBRSHRFFHbSfCbB#
#fBSFRFbSfSBfFBHCMBRCBCCfSbfMFFMfHHfFMHHSRBfFCHSRMFCbSBRSCMBRBHFCbSMBSfFbRffSRFbbBFffffRMMBbRCbBHBM#
#fFCCfSFCBfCfMSRBFFMFFCRbBHMfSffSHMbMFSCBSCCRBHMFHMSSSBRSfSSbFHBHHBCSFFSSFCRSRSFBBRfbHbMSBBRfRRRBfb#
#MbBMMSbbFSFBFHCbFRCHBbRBFSfFBFSfRRFHbHBHRFCbCSFBfMfFHHbSFSSRRbSBBMbBbfbfffBbSfbBRCHSRSSMfRRBSCRCHC#
#bBCMbCMRHFSFBMSFbSbRSbBRbMRCCfbSFBfBCfSMHFSMFCBbCBHSBffRfRRfSBMHfCBFCFRbBFSfSHFFSCMFMBbMfBbCRBbRMC#
#BRHFRMbfbRMCfbffBHHRRbfSBffMBRRbCHHBbRRSBBRCSbCCRCBffCMMbCMHSMfRCFBCFFFRSMHCSMRfCBfBHCSffHSSfFRFMF#
#HSbbCFMSfSSFMBSMRHMRfSHffbbBHBBSfRMHRHBFFFSHBbHSBCSBRMRbBRMMHRffSBCSHfRMMfFMSCRMfbRCfMfbSBbRFBMMbH#
#BHRCCMBCfCMMCMbMBFSFCFCHfCfFfMMHHHRCMRHMSFBRSHBRRCfBSRRHSMFHSFBFMSfbFBHbRHFFRMRMFFHRRSBfFCCRRbBSbF#
#MSMbfRRbbFHbfRfRFRSFMbSRMHFMFSBCfRMHHHCMMFBbRHfFHHCSFRBbHSRRMFRFCbMfFfRSFSBfRRMfFRHBFHHbRRHSCCBFMb#
#SHFfRCBHfSHRMBCSFFCRRfRBfMSHRMCHRBHHRCSSBFBMRbCSRSfBHMSCSSMSfRMHBHFBSBCffCRHRCHSBFCBMfCBRSSFHHSFRB#
#FMHHBFfRBBRSMFSSFRbRHbfSSBBSHBBCSSfbMFCRBFBRfRCfMBHFFRBBffbRbbHBCbRRCMbCCBFRCRMBBbSbHbSFbBHRRSHMSB#
#HRCMMbCCbSMSCRbMbMRSBCBRHCFbBHMFRSBBFbHMbSRHMMFBSBFFHCFSHCCMSRbFCHHffRSMRRFMMRRFfbBBbHfMHCSCHbRfFR#
#MSRSbHFCCRRRFFfFFffRRFFMfSFCBHFHHCRHfMSRCSbMBMCMSMMFbBfMBMCBbRHBRRCfBRCRRHMCHbFBBSfbSRbSRBMffFCbHC#
#SffHBHHHMffFMMBSBCbFbBBCCMSSSMBbFHFCfRBBbMHRHRFFBCbFFFfCbRfBBRRBbRMSSfMHFbCBRHfHMFfFHHFSfRbMbfMHBS#
#FSCHbFfCRHHFFCfCSHbMbSHbbBbHRBHBFSRCHffBRHFRBfHRMBHMMSBHFbbCCHFHHSCFbCCFRBbMMCfSMHfSBfbfSHfbCFMBCM#
#fCCbCSfbbCHfRBCCSFCRMMSSBMFMbRbFHSCCbbBRBbSSFfSHFRMMMfRSfMBSCSSBBCBSRFCFfBSHFFHHFCCbHFCfRFHSfBMCSB#
#MSBbBMRMHHSSBMMSRCHbHffBCfMBCFMBRHMFHMfBRHFFHMCFbCFBFSFbHCHMHFCSMfMRfHSRRSSbfFCFFHfHbHSMfbfSHHbBfR#
#SCHCMMCSSCFRbFFCMMSBbFMMbBRfCSfbSBCBBFRfMfFMHHbSbfSbHMHHFCFSBMMFSRBRBbbfMffSHCMHBSbSMHCbBFBFBbHSBf#
#RMCSHRHSfBHHRHFHMbSFRHHHFSRbSRFFfSRbBHBCHbRMBbRSBffMRBMfRMHBSMRRffRSHfMfSBfHSbfRfBFSSMCFSMSFFfBfCF#
#BFfSffbMBHBMbFSFCRRMRFBbbSRCHfSHSfRbHSHfFFMSFHSMBSSHfSRCRbCRHbRfMfFBSMHbFfSRMFCCbHFCRRFSFBSFSSHHMF#
#RFBMbSBMSMHSHFMbFCHMMCMSbHbbbMRfSRSfRCCbHfbFRHCBMMbBBRCBbSffBRMRbBbFCSRHRSRfMHSSRSFfRFSBFBSFHHHMfH#
#RFHRbFCfMSHSbSBCSHBCBbSCRMCMFbfBCRSSCFFbFfBBMbBRFbSSbRCSFRMSSbRfbCffSbSMHSbbCMSbfHHfRfCCBMfHMSFCbM#
#CbMfbMCHbFMHCBRCFHBbbBMbMMHMCHCSSbRCbbfRbfHSHMFCFMHCfFMFffBBCHSSSRRMbMRHfHfFCSFCFFRBSBSfRBCRfRFCSF#
#fCCRCBHBMHHSBMbfRSHfRCCMfBfFffFBHBSbFMMHSbbFFbSFbFBMBRHbCSSCHbRfMSbMMSCSbMSRRCRHRBMRFfCSbFfHMHFfbR#
#CFfHbbBSBRHCbMbSBCHRCSSSMSCHHMSBbMfbbFCBFfCffMCbCCRSSBHMFFHBCbFbRRRCfCHMSfCBHSfSbfRBfSBHHHbHfCbSfC#
####################################################################################################
