####################################################################################################
#bFfMfMFFfHHFbBMFCMHfBbMfCMSbfFCRHFRfSFfFffHRSRfHMCfCRMSHFfMHHfCSbSfBCBFMffFbRBFSCfMBbCfbfbCbMHHBMb#
#bMHMBRFMCfBbBRCFRFMRMRMMMFHFRFCHSMRCbHCHffRffBHbSSBSHRffSbfSRCSffHbFMbBHMBFMCFRHRMMfHFRFRBMFHSCBMH#
#bSbCHBSSSFMMSbbSbCSSHSBHBfbCFFHCSCbCFMCHCfSSCMbMSCHbMFBFSfRBMfMSSFRFFRMfHBMRfFbSfBfCSbFMfMffFCFRRC#
#CfCSFBSHCSfFRFCCbRfSbHFbCfCHbRCSbRRbSHbMCCCHbSMbfRBFFFfFfMHHCfBBMFfSBCRFSSBfHbMSfMFRHCCCRbRBfSMRbS#
#HSMbbCHHSbCCHSffMFHBHHRFMMFFbSSRMfBSMfCCSSFbCBRRffCFHBbRRSBbHSMfSHHbRMMSBbRSSfCSSRCMRSffbFHfMSSFHB#
#CBMbCfHRBBbBbHRBSBfCRBSCMBBRbfMHBBRBbRBRCFfRfFfFFMCFfCbCffCBFbCSCMSBfCfRHbfSFSMRRFHfHBSfCFBHHMCbMF#
#RfHfFfBMfbMHSHSRfMMFfHfSSFfMBMRMCCMbMffMbMBfHfbFMbfHbSMbBMBMbfRSRfSbMRBbRCSRfHHFfRRBMCfFRHBFCbfHSM#
#FHSFBBbHFFCCbRMMBFRRBCbHMfHFFBCBCfSFRMBfHCCfFCFMbMbbRBBFCSSHCfMBBRMCFMBfMRFMCHHMCMbbSSMCRbHBFfFbFb#
#FbSSRfFFMCMMbRCfFBBBMBMbHMCRSBBRMRBbRRfSSBbSCFCFbfFBFbRRHHBfbbfbHbCRFHFfMMHSHFCMBBBMCHHHRBbMBFSHHb#
#CHCbFCFHRFbfRbFHFffMFfSFSRBFMBRRbHCRHfMffCbMRBbHCSbHFMHHHRSFbfRffbCSHBSHFFRSHCRFfSSSffFSBSCbMMBHBM#
#MfSRFHfRBMfCMHFBSSMSHMbRMSbbMfBHFBCRBBSBfRBbCCRSRHffMHHCRBBSMHFMRCRSbMBSHbBfCHbFfHHfbCFSFHHfRMSbBf#
#MfHCSMMSCfbFfSFFSfbbfRSbbCFMSBHSHCSbFMfSBRFFfCBCBBHBCMBfCHHMbRHSSBMSCMFSFMSfCHfBHSCBFbBbCSMfbCbRRb#
#FfSCRCCHRCbbFHMFCbHHBHRRHHMfHFCbBRSBRRFbHHCMCCMRHMBffCMRfBbfHRBHMbfMfSMHBFMbFbSBBMSMbFSCFHCFBCbHHM#
#RfMCHfbbMbbRFHFBCbCCSMRBfbCRCCBFfFBMCCfBRBHfHSFfBSHRFMSfBCbfFMbRCMfBFCMfBBMHBCFMHSMSHbCFSFFMHSSFCC#
#BBbFSCFfffCBFHSHFMMBMBBMRCFFBfFSFRfCMSRSRRHMMbRfCfCfHFRHMfFMCBbFBfCMHMFHBHRCBbRRFbHRSBbHRBCMMSMRFS#
#SbHHMBSRHfCHfSHSBRbSBBBMSRRBSFBfMbFMHBHfBSCHHFBBRBCBfSMRHBRCSCSfMRbFMMFRfMHbRFHHFCHMMCRbCMRSSFMMRM#
#BMMCMbRMFRMHRSfCfffFFBRfHFSbCSHbHFBRSRHRbHbBFHSFSMfMRHRMHRfbBCRRRFBbfFFFHFFFHfFfBfMffbFBfFFbSfMRRB#
#SRSSRfffSFMFMRbFBMMSbbbMHMHMbBRfCHHBHSMFfHSRSBfHSCfFRRfMFRffRHHRHHRRMRbfRBMMCbBfRBHfSHMCCSFHMMBFMM#
#BCSRfBBFFFSRSSRMHBMCHbSRfMHffHBbfHCMHfHFHHfbBfFFHCCRbRMSbHMFHCFBFFfbfRBRRCBHMSbSBCFCBRbfffCCFMfFRR#
#bHCSHBSBfMHSHbbCfbfRCRbFSFFCBHFHBBfHCHfbbHSBSFBFBRfMBSHBHSFfbRHHBRRfMHMbCRbbMCHfSMHRFSbFbHBbSFfbSC#
#RMCbBFFHFHBBSbRFBbFbRRHSFFRBfMSFSHMHMFMRBfbFMHfCBFSMRbMbBSBMFFHFCMbBBffHbbHMSCfSMFMMfBBfRHBMfBfRff#
#HBfFSSCMRBRMbSCFbFfFBHBSbBMRBBBHMbBHMMBRSFFFSCbRFHfCMHCCCBSFFMHFfMBSfSSffSBMbbSHRRRBbbfFSMHbbbMBBH#
#RSHSRBFFMRRSFBCFCSCSfFHSBBFHRMfMfFSBMSCBMBFRRCRHHBMfbfRMSCBBCBHCRCSHFSBSSbMRHFbMFFCRHBfSbSfHMRHBFS#
#MfBFMffFMSbRfMRCBbCFBbMHBfFMBbBfbbSBCSBSFHFFbRMMSRBBRHBRfffbCbSCFCHbFFBHBCbMMCRMRfCSSHFbBFCbSMHHFB#
#RCfSSbSCSBFBfbCRRbffCHSHHBMMCFbfbFMbfSCRHFffCbMbHBfCCFCHBSbMSbMCBfHSRfRSbCFbCCSMSRfSfMMfSCfbFFSRFF#
#SfFFHSbBMFHHCBSHRfSFFMMBHfbFMFfSHbFfSCSBffHfSCCBbHMHMFfCRCRBMBBRSFHFfbRBbBCFRHBRRRMbMMbRFfSMBbSBMC#
#FRBBbbbRRRRBRfMfMSFFRCMbfBbFHfCfbCMSSfbMbbbbHHCCSFfRBfSfbHCRBSRCHBHFCfHbffRMBSfBbMRCBCHfCbFbMCMCFb#
#MSffCCSHbMBMFRBFHBBCBfbRBSfCHFCbBfSHbFbHBRMSbbHRSSFBRHbHCSFSfHBRCHHFSbFfBfSSFCSSbBMHHHCbbFfBbMMbCR#
#HfSMRHfFbMMBfRSFffSMMMCSMSRBfHFFSSbfSFfHHbCFCMFbBRbCSRbBCFMbRFBBFSFMbSbHCbMRMRbCHCFSbRRbFHfBbMHBMS#
#RbHSbMCMFfSfSHSHBfFBBfCFFbfSHFbSHHSMRFBCFBSCbBfHfBfFfCBSMFCRSBRbCSRCCSBSFfbCbHFbCFfMFSFFBRSHSMRSCC#
#bHRSCFSHHCRfRfSMSRHMbbbRRBBfFfHSSBBRSBBCSbfFFCCSHRRMMbMHSCbMHRMMRbbBSfFfSBMMRBMBBSMSfbRfSHbfFFbHBS#
#CRRBMHBfFfbBCSRSCSBffSBRSbFHRbRMCHFCbRSBbbbSbRCCFHRfMbBBCRRFbfMFMfMfBRfCBBBffbHRBSFbfSSbCbSBHRfHSB#
#SFFfRbCbRfHRMBRCBMSSSMfFfbbHFMSFHCFSBRCRFMRFBCBHCRHHbHHBRRFfRSRSFFbbHSBCCFRHBfMfMCCffHRMRbRMBbBRMS#
#bFCFfBfbCSffFCRBMSRHBHMMCMbbMRMMbMFHfSBfbfFSfRHBCRbCSHFRFfSbfRMHMCHFCMFbSfMMFRfCFRbSSfBRHSFRCSBHHR#
#bBBHBSBCSRSRbMBSfRMRCBfRFRCHFFBHMBFFCHBMSCHCBRMBFMHFFHHbSRSbSSRHfCbMRCBRFRRHRCfBCCCFFMHbCfHBBMBRbb#
#bMfMRHMMbbRfSbCfHFfbCCSMFCMfFbbSHHBCCCSBHBRbMCfSBBBRbMFbHBBFffBCbfRHCMbbRFFbFHFBMfFCfbfBFFRBSbHCfS#
#FfSBBCSfHHbMBfSfFMSBHHfMFBCMbCfffFHRRSCMCMFCBBBHHRSbHbRBSCSBMHbFfSFMSHHfHFHBRSFHRbSFfbCfMRSHbCRSSH#
#bRHRbMMHFbbbBMMbSSRCSRMCfRMHMRRCCBRbSfMSbFMfMSRFBfBSSfFbBFRMMbfBMHFRMSSRRCMHRHBMRCHCBHHHFSRHBbSBSF#
#SSHMRCHSBRbCSRHCCRBBMCSbSHCbBbCbCMFSMRMCBbbMFfRSCRFMbHFFBHFbHRMHBbMfRFHHbHRRRCBSSHFSSCfHbFSSBfCMHC#
#MBHBFbBMBMfMMBSSMMHbMBRfMbCHRSFCBHSBSBRCHFfMFHMFMCSCfBMfSMBbbRbSbRFbMbBHbMCbHRMFFffCCCHfRMBMRHCMfR#
#BbbHSBCHbRFCfSFfSFRHbbSSbHHCCHbSbbHCSFSMBSBRMRCHfbbFFfFfbbFfRMSCMMBRRHMMRCBSBFBRRCRBBbbBMMCbbfRFSf#
#RRMbMBbfFSFCfMBbFRRbbCBMHHfFHRHRbBbSFRBCbFMRFBRSRRFFHbBHHfbMFHCCHfBFFBHHSBHMHRbCRRMCBCHHRBFMBSHffR#
#fCbbfBCRRfRSfBHCMRHfHRFffHfSSSRCRBMSbBbSFfRBSHMfBCCCHbHSRHFfCSSHMfFRBMHMBFCFBbBMRbRHCSfRBFfFbSfCCS#
#RbCRRHSHSFSbRHHFFMHRCSHSbMFbBfbSCMFfSBSbffBBfHCFfMFfSfSSfRFRBFRfMSFfBbbbfBfbBffBHBRRMRRBCCSfFMCbHM#
#MFMFbbHfFfHbFCRfHFFBffbbfCCbRFSMbfBMfbFHRbbHbfMbBFFMCSHfBFSMfBFfMCSBBRCMMMRHRBSHbBfBBSbbMMHbMSbHfb#
#RFSMbfHfHbBSCFbMbBHHfbbSBSbCCRMHRFFMBMBMfHCfHCSSMBfbRMSFffHMbRRFHCRBHbFHHSBbFRfMRHSHFbCSRHFHRbHBHB#
#FBBCFRMRRCbHSRMHRHHMCMfbFCRMSSbMFMHRFBBSMMbSRbMMRfFbHHfbSBSfMSffBBMHCSfMSFFBSRbfRBBFHFfBBCBCRMFbMb#
#BRffFbHCfHSHFFRMRFFRBBHBRbSbFHfRCFSMRCBMfHSMMCbBCbbbFMSFHMRSfMMFRbSfMSHRBCRFBRBSfHfffbSMBHSMfFbbBf#
#BBHMRbMfSRBMRFfFCbBBCBHRFCCRRMbRFbMRHSbSFfbfRSfCFCFHHFSSRMFBRffHBRRfRfbBFCFHRSMbSFbSbCbfRFHFfHHfBH#
#BFHbCbbRCFbMMfCMRBBRCSFFffbCFfbHSCCFSFSfBSffFFFfRMMHSSHSRRFFRBRCBCfBFBCHbRSFCBHMMMCfFfBCMMHCMRbHFF#
#MMfCBCfCCSFBCCHBSBRHfSHfFFCBSHBMSMBBBbRfBRBBCMSMMCSCRMRSFBSFMHRBCSffMSSRCMHHBHbRSMBFMMSfRBHfBCRfSR#
#fHHHfbfFHCHRFFSSSbfMbBbRRBMfRBBSCHfCBFCFFRHbfSBHCSBbSMfSRbbHMBCCfFfBBbSbMCSMRSRCbHHRHSMHRBBfbBFHRf#
#FbRHbSHMFBfbSHBbHbMBfRFBFBCCBMRRbFSCRbBbfSfMCfSfbMHFBBSMFRBbbHFFCSBRFFRHfFCfBMMCFMCbSbMMRRFfSSBSFf#
#SRHFRFSMCbbMCCMFBMHHFFMBMBbFMFSSbCbBbMMMMFRBMBHMBbfSbbHRbBFSBRbRfSSSbFRBFfHbCRCFRBRBfRfHfFbMRRHHfH#
#FfSRHSfbbMHBMSCfFBRSMSCSBfCSMHCCSbfSFSHfHMMHCbSbbBCCSSbHMSHBSBMfbHCBCfBRRBBSHfCCbMSSfMHFfHMRBfSBHB#
#MFHRbHbBMBMFRfCfMFRSCHRHMfFbbBMfHMFBfCRMFMHRMFBRMMRMRCRMbbMBSMbbfHMfRbCCSHCFfHSFRfFSCMCRfFHMHfSRCH#
#HCMHfRfRMfMBCSSCBBMBFRMfbMCfCMMbfRMCFRFSMRfSSRBHSHSRFfMCfRbfbRMBSBMCfbCfMMSSHbFBBHRCMFfMHfFCbMfHCb#
#ffbbRFRfBMRSffFCMFFFRFCSFbRCCbfFMfHRMSfFBMHfCRMSSMBBHHCMbBBCbfBMFCRCRfFFHHMFBffFSHFHSbSRHfRbCSRbfF#
#BfFHRCBHfSSCBRbfbRBSBMSSbRBSHMFMCRHSffbHffMSHSfRFfRbFbHMSRFMFSCSFHCbSFSCfSBRCMHCSbSHBSSBRBCHMFCSbb#
#bFSMRSMHRHRBRHffRMFMRBbHBffSbRCBCfCFbFSRCRSbFSfRfFBSSBBRbbBCbFSbFRHfFMfBMMBBBbCRBMBHFRRRRbFCRBSRBf#
#fCCbRSbCCRFbSRCMCFSHfHfMMSSbfRRbfBHMfbCCSCHMbCMSFbHbMBBHCSMMRHMBHbbCCHSfHCFCRFHRbfbFfCSBRfRSfFHbRR#
#MFSCRbSFRRBRBfCFHCCbRHSSfbFCfHbBfffbSCFCCbMHCFBMRRMCHHFRFRHSSMSSHFMBHFRSCHRRFHFFCSMFHSbCfHRRMHFSHH#
#SCBCRfRfSHCSMCMCfCFBHbFFBfFRMHbfMRfRbCMCFCCBMBHFSBFfRFCRbBbCHFCbSHHRfCbFCbCHfBbRRfbRCbHCCFRRbMbbBf#
#CHfbFRfCHCHRMCfSCHRFbSMMfRbBFRMRRfBfMCRRMbbRFMBRCHSMFMBSBMfMFMBMCCbHRFbFbbSCMSSMMHMBMHRbHFMRRMBbfC#
#bSCbMBFBHMSbMRCbSCfRfBBFfBBCFFfFFSBRMRRFRRfbFMMHRSMCBCCRHFbBSFCHSfMRHCBbBfCFfBCCfHbSFbRFMffSRMBHBF#
#RCSHHMbbBfHbCHHBMHRHfFRbBMSbBbCRfbMRFMMRBMRRSRbCCFCMBCCFMMHHbFMbbHfHBSHFRRBfMFbBbBSSMBSMBMSbBfHBfF#
#fSRCFSbMfbfCFFCfFfMCMBCCFBBSHCBSSRfBbMSSFfFfRfbRMBHSSRSfBBFSMFbSRbFBHbSMRHMMCfCMHMSffbfCbbCHbMbbBb#
#CfMffCRCbffCHRFHRHHCbBbfHBCCRbMFRCfSCFSSHfFCbCCRRFCCBRBBFSSfCMHbMSMBSBRRbfRfHFMFffMHCfbHFRCRSfHMRb#
#SfFFHBfMRbHbSfBHbHbBHSSfBCbFMRBfMbFSRMCRHMCCFHbFBMBHHbbRfBfffBbRHRHFSbCbCSFMfFCfffbSfHbRFRCCbFCSSf#
#fFSFCMCFCRSRbCSCbSBSHBMHRffbHHbHCfBSSCBfMHSRRRSRFFFSbMCFMRMRFSMSSfBSHfRHRbFBFfCSRffCSSSCMSFRRbSBCf#
#CCCCHBSMSMBRRSFCBRMRHFCMFbfHCHSCRfSSMHHfffSffFFHRFBHbSHMSMHSHSSBSCCRfRCRSMMMSRCBFbCbBBbCbSFbFBMHbR#
#HfbbFBFBbMFbCfBbSCRFMRSSCbFffRSMfbCCBFHSHHfbSMCCbBMHbCfRFCCSbbbMbHFFfSRfFCFfSBRHBbHbSFBFMMCfbFFbFB#
#fHBRBSfSFCMCRRMSCMMBMbffFSfRFBfMMffbMFRHRbFfBCCMbfBBSbHRSMFFfFfFSfFCBCSFSCFMfBBHBfSRHBCfMHHMBCRBHH#
#BHCRbMFRFMBRbfRfFMCRfMBSfMCSfbRRRMHBSCfbBHCHBFSbHHfFFfBMMBCMffCCCRHSBCbbSSRffbMHbSBMFSfMBfSFHSRfBH#
#HCBCFBBHfBBFCBCCCHBSBHHbSCCbHSbbCCbHHMfBfHSCHSfbBRHSBBbSSRCbRCHRbCCHbfCRCBfbfFfbHbFSRfbCCHRRSSFMRf#
#BbCFFBFFHfHHFbCCHFbBCBSCfbBBFMBRMSCfBFFBRRRRFBSbBbbRbbCSCBSbBSCfHSRSMFSSbHbHBMbBFHbCBfRSSMMCMfMHSS#
#HCRCbfFHFHRRBCfHBFFSFBHFfFCCBRBMCfMBSMMCRBCRMSbBSCFbRfBFMSBCfBRFBCSHHHBCRbfRFCbHSRFRFBFRRbfSCRfbCM#
#fRRMCfFCBFfRbHfbRRMCSbbbCfHffFBRFSHMSBSSMBBSCbSCbFRFCMMSFRRfSSMMMHFCMCfRbHffCCfMbSSRMMbfMBfCMRfHBb#
#HSbBFSFSSFRHHHbHbFHSHRRCBBSHRRMSHMBRfffRbHbHbSSFfbBRFCRCCHbRCMSRbRFRfHHSFHRSRfCBHbRRCFRfbRBfBFMCCB#
#bCRfRCHBRHFMMSCbfCbMHHBMHFbMRHFCRMbHBfCBRBfMbFCBRFFbMbFfSMCMMSSMRSCCMfFfSbSfCBFBbMfMFSfFbHHSSCMMBf#
#SfffHSCfBSbSfHbCMBFSbbHFMFSMfHMHCMfBBSSFbfSSRCSSSRFHBSMBBSFHBFfSCRbfSbCbfFCRBfRFFHCbFBMRHbRHbSFbfH#
#MMRRRbfSRFFffRbbFCCCSfFFMbCCSSHCSFCSbMfMSCHFRSBFfCfBfHFHBCbHRBFRBfbbFSCFffMRRMRBMffbbCSfFHMBHfFRFf#
#fbCHMMbffbCHRBfRCbfSMSCSMHRSRCBCRHSFRBbfFSBHFBBCRFSSBRFfMBBCfBHMHCMCBHHFRSfCfCfSHRSBMBBfRMSBbMBSRC#
#SbHSbbfFCSHFBCMHHSBFRBFFCfMHHHSBSRCFMSSFHBMRHBSHfSFBRbHHFHfBBBfFFSRfMRHMFbCRBMCCCbbHffHfFSfRfBSHHB#
#MMRSfSFHMRHfbHRMFSBMHCBFfBFSSCRRMBFbRHSbMBSCfbffBRFBBfCRSFbSRCHCCSSBRRfSMBCSBfRMRCHBfCMRbBMfSbbfCB#
#RFMMbFFfbSbffbCFFbRHCMSFRfBBFfbFSRBRfMBFFRFbfSMRRBfMfFHfCfMbBfbCFfCBRSfCMCFfMCfBRFCfFCBbRbHSHCRfMR#
#RSMSHCRfRBbMFRFHBFRbHCCSMFSMFMCBSSHRHSBbSFSCfMSCfBRCFRHBRbBCBSbHMMBbCCRRMfbSRCHBCHfHCCRRSHfMFMFMSM#
#CHCHHfHHRfHFSfMbBBfBFFMCCHCfBFFHRHMHCbRFfMbRMfRMMbHCRMbBCBHHSHMHHBSMbMBMfMHHfBMRHfBHCSfFRHBCRBMSMM#
#HSbMFBCFHCRCFBBRSHRbMbBFSFSRFCHHSMfRfMBCSBBRCMMRCfMSMfbfCSSMRCfBMfBBCMFFHRRSfbHRRMFHBffHRCCMHBFRff#
#fSHSBfBMMHbBMRfBBfFHBCfBMCBfbHCMRRCHbBSRbCfbHSBfBBMCRbSBMSSRMbRBRCBSCMHfSBRCMFfbBFMfRBbMMFfHfSRBRS#
#RFBFCBRRfHbRbbRFRRRHSCbSMffHbMCHFMfCFHMRBSBFMbRRSHFBSFfCRfHfFFSHSMFMHSbfRCffRSbfHCBCRffbBfHBCSFRCM#
#bFbfSFbbCSHMbbbCHSMFbBFHHbfBSBSbBFbRRHbMMCRMHSHRCCBCbBMCFCBRSfffCHMCMFBHMffCMBHHBCCFCbBCMFMHHBCFHR#
#bBbCSBMBfbRBHMFCCfBHMCHFHMfFMbRSRSbbHfFCMCFCBBbbSFFCRFCSBRCCRfMfSBFSfFbbBRHCBFFRbFMFBfBMBHHFMHRFSM#
#FRFFCSRMSMBFMRpMFfbCRSfSMfCFSBBCFSBfCBMbFfBMbSRbFbFSCFbFBbRbBCFbbMbBRRBBMFRHMSHbHBFFbMCMFMBfCCBHRf#
#HCRHHMbbMBMSHbMHFbMRSBRbSMfRbfSRHBBMBRHCFCBRFRMHHRMRSRHHFMSCSfBSbbbCMMfCCMCbBBSSRFBBFBbSHfCHBSSfbS#
#fbbbCBMHBMFHRfMCRCFbbRFMBCBSRMFBfCCMBCMSfHSBMfHCCMRfFBbHHbRfBHfSMRMFCSRffFSCHfRMCFBMFRMFFBBSRRbfHM#
#FFSSFSHMMSRRBFCMFfbHHFSCSFHFHSMSFHfbCbFSFFfMHFFbbHRBFCFMfRHSfSCfMMHfMRMCMfCHHCfSFbCBBRSRRCMMSRSSCC#
#bFBHCCHCBFBFMRfBbCSbSbBFHbMfFHFSRBMSfSBHfRMSCMMfCMSRBBfCSCCSSfSbHfSBMfSCSfFfSfRbFfMRSfHBHfRRSRbfMR#
####################################################################################################
