####################################################################################################
#bHbbHSfRbfCHHfRRCbRHSBFRfBCfSSffBBFBRSMSCBBHMMFSMffHFSFbHRCbRSBCHHFCFRffbMFHBfBBfBRBSMBFHMMSMRCSff#
#bFHBFCbHCFMHSMMSHSBFBHRRCFSRFSRRFBSRSfFRRBFSfBHMHHRCFHfbBBSMfFCCCFSBMBbRFBRHBbRHHHRFCBCfBBbFCCSffS#
#HRRfSFSSMFfbFMBHFMBMbRbCMbSFHRSfMMBCRRbFFfbfbfHSfBRMSbBbRHRHfBHbbbHBSMRfRMfFFRRMBbFHHCHBHCFSRRSMff#
#HffBFfBFCCFFbHSCSRSBfHCfSHFCRHCFHFSfRMBSfbFHHMSHBSbRbCfFMFFBBMHbSRRbFRbFMSBMBbMFSHHBHRfMHbSBbMFfCF#
#bMfRMMFMMCMSSHbMMfRBBMFHSRCBCHbMfBHFBSRBCCFSHMFBFCbBSSSfHFHMSMbfMHCbMRbBBSMSSSFRFfMbSSMSfCBBHSRFbb#
#HMHbMbCfCCCbHFfBbbBCBbBMHFbCfHSSSFFMHRRSfffHbSCBFFRCfMCbbbbFCSCMfMBCRMCBSfMffHbFBbRfSFbMBSCCfRRCbR#
#FRfCMRFbRRCFMbBFfBRfBCFCMfSffSMHfbSfffHfBMCRCHSFbbfCbCSRfRBFfbCFHbHBFCCSbFfHHfBbCRbHRMbFbBSRSHHMSf#
#FCHfRSBSCHCHffBbbRbFSRBBRMRRMfCCfbbCBMRCfSRBBCSMMHfBfBRFCCfHFFSRFCRfHSHRRSBMRSMfSFHRRMSRHRfHFRMBFB#
#fSbHbfMRFfFfbHHFRBMHSbMHbBMRfBBBMbFRbbfRCCffFbfBbHfHbBfMBCfSCBHMFCFRRFffFBFCFfFCHHSSSMFBRBRfSBRSFb#
#BBRCCBbFHHfSfMCbSCMbCRbBMRRfCFBfRMRCHRRCbfbbHFHBbCCbbRCCMffFfBHMfCSfMSBMSFFCbBFMHSRCRbbHRBBFBRBMCH#
#HbMRHMMSRfBRbBHMCHBRMfbMCMBCbSMMRRbbbRffCRSHFCMFBbSRBfFSBBRMFSRCBCbBFFfCHCSFfbBSBRfSCMFbBCBMMHSFFF#
#SBFMRbMSbRBBSSRbCFRFFCHbfSfBMCHMCbCRbRBSfCFCFSHCSBfRSHMfbFHHRSRMRFfRffHHSfMBbMMSBCCSRfFSCHRHFMbSFM#
#SRRSFHFRMBFMBBHHfFfSCFCRRSCfbRBFFSSfHHfRfSMRRCSFCMffbMFRbFCbBRRRFfHFFFSFBMSBCFRbSbfMHMCSSBbSFbHRCf#
#FSfbMSfFMfRFSSbBHBfFbRbfMRHRbSHfCHFBRbfRRRbbFMHCBCCMMHFRfCSRHRHCFfBHFHHbCSbfHFCfbSSBBCCbRCHSHCHRfF#
#SHHFbbCHFSRbMCSCbHRMCbRSMfFHBFMFHbCMCCfRCSMfRRSFHbCRSSbSCFBfbHSBSCCCfbSSSMbFSMMfCFBHFfSSHHHfFfSMBH#
#fSMRRBfbFCMBfSfFMbMfSMSCRHSBCbfFSSFFBFHMBffSFBSCHfFbFHRRFCRMbSMfSfbMBRBCSHfRBMMHSfHRbBSBBHBMfbMSCb#
#HMSCRRBbRCMbbbHBbCHRMHFHBbBCSHfbHFSBMSfRfSFfFSCFBCCfCRMbfBbSSFMHHMbMbHMCSffCCCFBFbSFSFRCbHCCHRMfCF#
#FSFRbMbRSMSRFCRHMHFBCBBCHFbSRHRHFHCBMMCCbFRCfbCSBBMffMCFMFfRfMSHSfCSHBCRHfFSRbRSBFHHSHBSCRRRCSbfBM#
#bMSHMSbMMfHRfFbRBSBMBMHfSRCMRFHSCfCBbBSHRSbfRHRbRMCFbSMRRMSRFCRHbfCBMfbHfMHMCBbfBbbRbSRHBFCbbMRRfS#
#HFbFRBBSBFBHFCFbFMRCBCFbFBSMBBMFSMSMFMBfRSfHfHRCHBRHRbRRfBCRMSMbFbMbSRRSCbBfBfRSHbBFFRfBFfBSFMFRMC#
#SHfCMFMbfbCFCRBSbMHbSRFfBHRHHBSFFFbMfbFRbFCCbBMBFSbHHCBHBbbCRbSFbRBSRBBbbSSRRRFMBRbRMFSMCSfbHCRbSb#
#bfbSSSBbRSSBbBMSSRMfbFFFbCFBBbfHRFFMHRMBSBHSBFCRbbCfBRbFFCFSHMBMBHFfHbbCCMbBFbfbHbFbMMBbBHSBFRbRHF#
#MFSfbSHBFHBBbSFMCMSMbfSbSBCFFRBffSbfCFRCFCRBFfHbCCMSHCSHHRSCFBSHfbbFBCRBfbSbRMFBSfSSFRCCMfSSfHCHCS#
#BfSMFSCfHbfBHbSRbHBBBHbCHbRffSSSFSfHbFCBBSbbSCbCRbRHbFHHCHfHSffMMHMMFCRCSfHSbCBHFFRRBCSRfbbfbCCFfF#
#FMfBffHCBMCFBbRFMSFFfBSMfbMfBBHffCHFRMCRSRBSCRRMMfHFRfCbCHCCbRRfbRbSBSHBSHRMFMRSHBRBFRHCFHSbRBbCHf#
#CBMHMFBSFBBMFSBfRBBBbRSCSfbfMHBBCHbFfMFRbCSFCFbCRMSSRHCFFRHSHFffHCRfRMbfBHbfFSMSBMFBbbHFSffFHFCfSS#
#MfSRFFFMMMCBSbCRfRbCBCRfSBHSCRRBbBFbCMFbFfSFFBSHfSfRRCHfRBCHfbSHFRMFMMCbbHSSFFBBSCSBCFHFfRbRBFCMMS#
#RbFHSfCbbRRRRMFBCfMHCRSCRCMSMMbHMHFbCBbBCFCBRSRMbMCFBHMFFbbRfSRMHCHRMbSHCSCCfbBbRCbCMCBBFSMRfFCSFB#
#SMbSRfRFSSBbCCHSfSMCCRfCffbHBFfFBMSCbbSbRCSCSfRCRbMfFbCRRRfRbbMFfHSSSHRCRfFSBFCbSSMMRBRbCCMHMbRHMB#
#HSSRfSbSMRHBHCRHFBfFSHHRFHHHfRRSfRSBMMBCSMbHMbCCHSfbRFMFFSbbMSSMRSRHbBfCMSbSMMHBFRfHMCBHbHFHBMBBMC#
#CBMHSbMMCCRRCfFffBSHHMFCRHRBMRFHffMSMFMFMCFMCbMRSRHBCFSBSCbBSFCHHBCFCHMHffCHCSRfCRFFBFMFHbCBffMRRM#
#CHMMCHfCFSHSbRCSCHbHHSMBBCBCCMBMbfRFMFbFFMRHMRSRSFFfCSBfSCHMbCRfRFSRRSFMSfRHbRbBHFSffRCCSbSRMHCMMH#
#FBfRHRFbRBCbfHBBRFbBMMMbBHBbSHFFCfCfFbSHHBfMFBFMbMFRCBHRMHRFRFMfHBHHHfRFSSRffBFBRSfRRSCSfSRFRSFSSR#
#MHFfbBfMCfFbSBbSSSRfFBMBFbCfMBfHCMMHCSBSMRBHSfFbbfCHRMFbfbHRCRfHFBCCMbBFBfBCCfFBbRRFfFFBCHMfSbbBCB#
#BSfbHFMfMCMBHFbRbBfCMFSCMHMCMHRSFFCFbMSbbbRFfMFFCfCbHHCFfRMfFfMBMCMBFMbSBbFMCMfFCFSMHHCMFBCBfFSBBC#
#MBMFMCfMFSbBSbRbCHSHSBRHMHRMfHMBfCfCfSfFFFBFBbSMCbRMRSFFBBSSbbRHCMFBHfRSCHSfHMffHCfSbFCSRMFMMRSMSH#
#BRCbbCHfRSHMRHbRFfRFRSFfbHbHCRRRbBbbBbRRMFHBSbHSHBMBHFfMbFCSRHfBHCMHSMSbCHFRBHfSHFBFFRMHHBMSRBRFfF#
#HbFMHbbMFFFRffbHBBBfBHCHHFHFCBBBSRFSfCCRBBRCCRHBFfHSbMFHRBbfSHFMFMfFMCCBMbSffRSCHbRFCHCSRbCRBCRMFS#
#FMFffHfFSSCMBFbSRBSMBSSHMMfFSFRCFBbHSSfBCHBBfbCBFRSRSSbFBFHfHfBRBCCBfSRCRHCFHbbMRbfCRSffCHMFSbCFBB#
#RRMbRMbFBbFRbBbRMfRHBfFHMFCRfCRFCHFfFRCMMRfMMMSSBBCCFSCMFfFbbRRSRbCCRHCBMBRHfSMSHCFCCMBCSFfMMfHSBM#
#FRCbFfbSFBSHBffbbHHFMMHBMRSMHCCfMMBRMRRCFMMBfBRBHSBHCHbRbfbHSBSCBCfBMFFbFHHFHMFRMMHHfBRfSfffbFFRRH#
#CRHBRRMMFHbMHCBbSCMHfRRBFCFMbSRSbCfFFFSbHHRMbSCSFfMCCHFHMCMbCRHSBBHMBFbFCFHfCHMFHBfCHCMMHMFFSbMCBM#
#RSFbHMSCbRbRbSBSFCHBSHMMHBCbFMCbCFBFFBBRSFMSBbfMCMfbSBCCSfCbBBMMbMRRbBMSMBMHBBfRbRHFFRFHbfCRFBbMfR#
#bSfHCbMbMCMHRRHHSMHHFMfFRSMFCFBBfHFBBbfBCMHSbSfCSMSCSbSRfFbbHBRMCCBHfSMHbSSBbfbFFSCMBSBbMbSCBBMRCC#
#RfBCRMffMRbFCFCBMRCBHRBHbFBRBSbRSbBFHFbfCSMHBMfMbBBfbHRFRbbMfBFBBSMCfCSHCBbCbfBfSbSMfCSBfFMHHRCFSR#
#HHCCfbHHMSHMBMHMBMFCHbHCBBfbRFHbFBRCBSHFSSBMBSMRMMBfCbMbHSBMHMBMCBSbSRMSMHFBHSfRHCSfCRRSRFCHbRRSHH#
#SSRSFSMBffRbFFfRMBRfFSSfMbMRMbSFHMHMBCffFCCMRMBHbSHBRBSHHfHBBFRSRHbSBMCbfMRHbFbRSMBFHHHRHSSFFRFfFb#
#RFRfBCCfBMFBCBSbCHHRSBRRfSMHfMbHCCHMHfMfRHbSbHMFCfBfBSHBFfbMbbBBbMSFSSRBMCMMFHfSHFBSbHFBRbSCMCRbBF#
#HMCRBbHHHMHfHHSHBfHRCbSSbMHFBSMSfCRFBCCSCHbfRHMHfMSRFbbFbRCFFSfFbFCFMfSbFMCBMSFFfBBRCFHfRHFfCCHbMM#
#RfMCCRfHbbHSFCCfRSHHBMSMMFfFMFMCCbHCCHBCMRMBSbCHfBSFRCBMfSRMfHHBfSSfHCBSSCFHBSMBSbMbbfSMFfCCRSfRbF#
#SBSfMHbbfBMbBbBBSHfSMCRHSHBFRFbHRRBHFRBfFCSRBBRHbHbfMbRRCBBRMHMBfCSCSBBbbBRBRCBMHFfFbMSHFFBRCFMFbR#
#RfMCCBRbMFRBHHFMfCbRMfCSCfSCRSbbfCFBBHBHMBfbfMbbSHFfRBHCRFCCfCCBSHHCFbCCHCbBSfHMBCFffRBHbfMfSFbbSR#
#ffCRMMMfbMMBfSBFHFbbMfCRCfFffCBfFCCHfSMRBHFfBHHFMHfSfCMBFMFCbCCbSMBBRBRfbHHSHCfSbRfHMfCBCRbFCRHfCb#
#MCCFSCHfMBSfffRFFMCfHRCCRCRSRMfBffSfSCSMCFRRRbbBMSBSRCbFMBbfCMMCbSBCfRHfBHBBMfFRCHHMFHMRRbSRBbRBFB#
#MRCbMFFSHRFMSRfRMCHfSRBCfMRBHCRRSBRBFbFHCSRBBRbMSCCSFFFCHRffMMbSFFCBbbBfbCHBHMbCMCRbBMbHfCFFFfFFCF#
#MMbSHRHBMfMRFSfFbMfRMBCBFSSMfRBMHbfRMfFMMCSSfbBCRHCHFBBSBfSMfbSSfCfRHbCMFFBbHMffCbCbMHbSbCFCSHMbHH#
#FFCMCbMHCbBfSRFFfMFSbfBRFCbBBRSfCCfBRHBSSBSFbBCbSHFMFMMffCBHFRHCbBMRCHHHRCFfFFBFbMMCRffCHbMCBMCBHH#
#bbRMBFBbbMfSMMBHFRfCHHRfRCSSBSSfSRpfbBHfFfHHfBCRSfBSFCSBFFFMMSMRCMSHBMRbHMbSFMFbBHRRRRSFCffBfHRRbR#
#BRMHCCBHHFbFRHbSMSfHBMbHbMHSbbHSSCMCbRSfMRBHffBBMFRRbHHBfSfCSFbMBbMMbRBfMRSBSCBSbRHSSMbHCfRBBCSbHC#
#SbBBBFRHMRfMBSRSMfHFMRHHMSfMFfbSCbfCbSHFCfSbMFffFCCMSRMMCfSFBMFMfMHBHBRMHfSBSfSHHHBBFFHFbBSBHfMMfb#
#RbFBRfMSMbSHHFSfHbCbfCBfBHSbMMHRHCBSHMMCCHFCSHMCBFHFRCCSMFCSFCFSfbfBMfMCMbRbbbMMbfCfRMbFCbMBRfRRRF#
#bBCFRFSMBSFBBCHCHFBfRbfFBbHSCCHfCRCfbCRfRFFRHSFFSCRCMFRRFSSSbSSHHMMCCSCHMMfbbRHRBFCMFRSBFRCCHMMfHB#
#SBfCRBfSBMBBCRCHbRMbHffRMSbHHBSHCRBbBBCCfBCSRbFbMbfHMBRFCFRCffRBMbRCBbbRBSRBRSMHSfCCFSSbRMfFHCCfFH#
#SCSFbFRRfFBfHHMBFfMHHBfRRFMRbMHFBMbCFCHFMHMHfHMCRHbHCFSRMFbRBMCSBRfSHbFfRCHfMRMbRRSfbMBBBHfRBRFMFB#
#BfRFfSCFHBHFCbSRBCfbfBbMCFbBfHRMCSFRMSFRFRMHCffRbHHHFRHHCRBBbbCSSCfbSFSbSBMfSbMMFSfBCMMSBMCMMfBfbB#
#MbHHbRbSBbMBBSFSBBRbHCBRFSCbRHCCMHMbCRHRHSSFMRCBCBHfMMCRCMRRCBSfRHCMFBbMBBCFfRfbFHfHHMBFHCCFBBfbCM#
#RCbMfRRFFBMCBMMFBMMRHSHBHHHRCbRMRfMCBbBHbFCSbBBMfBCCMHMbRMBSHfbHSHFfRMSBHCRFMCCMCfFbbSfSbRHRCBFBBB#
#SBbRCHCFHSBFCSCfFfMbFSFRSbfHMbSBfHCSCMRBHffHMCCCfSSHCHCRfCbfRHCBSSCRMHBbHHRCSfbFRHBMCbfMHbFBCMCMHC#
#HSbfCbbbCMMSfCSffRHRfMbMbMfSFSRbfHMRHSHMMSRBbBHBMBFMMfBRCRHMBRFRbSRCRHfBHBBRBfBMCHMCHBHRFCHCFfSHSB#
#BfHbHFffBfSFFRBBbBfMBFRbSHRMHCSfFbMfbbbBSHMHCRFBBRBHMHCCSRbfCMRCSRbSHbHSFHRHSSFbBBSBHMMFBRSSRHBHfH#
#ffRfMMMHHSMfbSbSCCFffFFbMbBMRBBMffMCRfCHRMHCfRfRSFHFMRCFBMfBMRMBfHMHRFMFFBHBFHbMHRMBBMBCRBFbfBMSHM#
#HMHfRRMSfRRHFSBCCRMBBMFSbRSBBSHMRFSbbCffBBCfFHCCRBFBHfHRCFBHHMMbfRHFHBfbCRSffBRCSMBMBBMfbHfFMHBCBM#
#MHFbFHHbMFMSMFSSFCfBFHFCSbCbMbSbbCCBHCfCBbMSCSSHMCSRBBRSSHCMBRRfRHBbfCHfbfBbFCFHCMBfRMFCMMRCHRMRMb#
#CfMfRFffbBMHBRFHCMCHCHSSFbRRSFFFfFBbfBSfHRMCBbBCFbBHCbRMbBHfFCfbSBMBMCHbHfMBMFfMSMFBFBFRfbRMFRHMHM#
#BCRbHBbHMfRHBFfMHRHRFSBHCRMBMfBRFMbRBFFbbRHbbFHfFFSSBSBRSBMFCbBBCCBbFSHBfbHSBSCSbCFRbFCCBfbMMHCbBb#
#CCbRCbBCSSCCBCBFMMBCMRFRbBCffRRMfFCHbCFFFMfFMCRRCFRHfCbCMBCRfbMbSCfFCMBCSCSRRbCSFBFCfBHMfHSSHfRBSH#
#FRRHfBBCBRSCSFFRfCbCRCFbMMBRSfCSfCHfBMBRRCFMMCCBBfHSRCBbSRfHRbBSbHbMbbMBMbBFBRCCSHfbRRRCMMHHRHHRBF#
#BBRMBCFHFHFBHFSFMMSHFRbMMBfffbfMMBSRHRHSMFbbbbbSCCfbBBHFfSBRbfbbCRBSRbfMMRBHRMMSCffFRRBFRMHRfRFfFC#
#SfFbfBBBCRSRFHMMbCRbSCMBBfRHfFMCBBBCHbBSbFbBSMBCfSMfHFMMbbHHRRbSFCCMSMSMFFFbRfBHfRFSBMFCSfBCFMbRSF#
#BCCBFCCSbRRSRBbFBSSSffCbfSMbHfFCBHbfBfCBffffHHfCfCFRMFSHCfFHHCRRBRbRHHRHMMfHSfCFBFSbHBMfbBfRSbRSSH#
#SRBRRFMHHMSFRfRRfSffbMCbMbCCMBfbFffFRfCSRfbCMCSCRFHFRFFMFSBRRSFHbBRBMRMMFHHSMbSMFfbMCbbbFBFBfBHFBf#
#bfBCSCCMHBRHHRCCRBRbfRBfCSBbRfRSRMFRCFHHFSBSfHMHfMfMCCRFfRbbRRfFMBCSBfCCfMCHHMfSHbHBfCRFSHfSBMRbCB#
#RSRHRHMCbFfBCHSfSSHMFSbCRbSCFFRRMMFHbSbbCfSbSSRHFBMMBFCFbFMCRBSfFfRSSHBbRbMHHSMbMbRMfbffFMHSCFfHCM#
#MCfBFFRCFHfFCFRBCFfSRRRBSHSfCHHSCRSfMSFfSfRBRCMRHfBfHSMBSHSFbCFBCffHHbMMCMfHMMfbRBRRBBSbMCffFBFbRS#
#RMBCMMRSSCfBCSBCbCfRCfMRCMHCSfFRMFbfCfffHHHMbFSBMBFMRMFRMRSMHRbMMRRbMHFFFSbMFfbCfMbBRMSffffCSCMSCF#
#SCbffHCFbRfbMRSfRfHfbSFMHbFSbHbBRBBCBRMCSbCFbRfBBBRRMRbRMbfHRfMffSHfMRRRFMSBbFRBHHHMMBSbMBFbfFSRHB#
#MCCBHfRHRCbCHRCfBHMRCMFfbFffbFBRCFSRHMRFSbHFFFMMBFHHFHBbCMSfFHfbFCfMMbHHHRBRBHfFCMHFSbfbMHHbBbSMRf#
#HbSbHFFSBMFSFbSCRSMfCbfFCCCFRfBbRFBRHfbbSCBCfCbCCbSfHffHBfSBRfFSbBMBfHFRHSfBHRbHBfRFCFFfSFCHMffSRF#
#SBHFbFMfRRbHRFFfHRbRSbbSSCbBRSHFHRHSSMRbBMCMSRfRSFbFBBBMbRHSBCSFMBbHbCFBFbCBHbCfMHMMHHFbffRbfRFRHB#
#HFSBFMHCRfbSbbCRRSbbbRbRHfFRCMFBCCCSCCSBSFMMMFHHbSSMHBbMFFBRbCHSHSMbRbCSfMBBHHHBFBbbRfRMMbMffBMFMF#
#MRfRHSMHSHMMBSBfCFBCfbFRRffBFRRbHSFbFFFRHfFCFHfSbFMRHHCbfSFHRbfFSMFCfBHBFSFHSMCSHFHMRBfBfHbSCFfbMC#
#bCFbCMBCfSHRfBMBRHSBMBbMfSFCfHRbCHBFSbfCRHFFRFFSRCBCbSHRSCBRbRbBMfCCbfHBHFMHFRSHHHSSSCCCbBRFHSCRCS#
#MbfBCHHSFCRRffRbMMfFHRMbbSMCFSRbBBfffbBCBbHMbBBBMCCRFBfCHBbRfSMSbfFRFfRBfFBBfHfMBfFFFBHRHMFFFMbMBS#
#fSRRSSFBffRRBfCfbCBbfFfHCRRSMRffSSCbMRBSCRBfCHRMSffCfMBMCHCFHbMMSSbMCHHbRMFbbSCCFffFRHBbRMHbSRbffS#
#HHMbSMFCBCRbHRMbfbFFBRMCBSFRBSSbfFbRfFFRFCbFRMCRHRHRSCMRMCRHRSfHBSfMbbHHFFBFCffRSCbFbFffRFBBbbHSbB#
#HMHRbSHHFRSSFbCRMHFfbCBRRHFbffCfBSRbbRBCBBRRFRFCFCFfHBHfHBHFRbbMMbRBFBMHCCHRFFFSCBFbFFSCHbCSRbRMBR#
#MHbRbFHRFHCBMbBMSbHRFbHSHRFbMffbRMBHSbRHHBSCCFSSHRffFbMMMCbbHFFCBSHFFCSBMBCCbMSBBHbSfCMBHMFBFbBRBf#
#MHRMbRFSCFBRMHSBMRRfSCRffHfRbMMMCHHCSSRFFSFfFMbSbMFSFfRbMfMSCBFCfFBMCMfRCCRRHBRHHffSFSFCCbMHFBbHFC#
####################################################################################################
