####################################################################################################
#FHbBbbBRRBfHCMCbRRfRBBHFBBMFRSHbHSMFbBHRHSMRHHRBbHBHbMCRFbMHCHSbSFRRFSRffCBFSMfFfFHCBBCMBSFSCbbRMM#
#RFMRFbRCCbCbRbHHCFMCbMHCRBRHRBSCSRHHHCbRffSFRCMbFMRbfHRRfRbSFffMFfSfbBSfHCHSbMBRHFSHRHRBBSMCfHHHHC#
#FSCHCRRBSFCCHSbfHBMFMBHFbFRRFCHCHHBMMCHBbMFRHRHfCSCFfbfHMFSHMbCBMSRMfMfBBHCFHFFMRFfbbFCbFSFSbHRfSF#
#BFBMCCCSBMCRMFBRSSSMCSBHbFfSSHMBFBBFRHFFFHFSCfSbBFbFMHMfHRCMSfSFfffMBBbBBHbHHSCHRCSRCFCSFHfSbbfCRM#
#bfMffBHCfSBfRMFffBfFbRMFRFFfRbRCBbCHBHfCCBHMSRRHbbbHHMSHfBMSbSSbFBbbSRHfMSMCSRCBHbCRCHFFCCFRFBSRSM#
#bHfMFRMSBCbMfMHSSFBMFRRCBHCCfRbCbMRbFRBCRCCfbFSBRHfMbCMbbMfRRMBMRBCBMCHbfMRMfRfFfHRCBffSMSBSCfSFMM#
#BbfFbffffRBfMRCMRMRBBSBffbRbBMHFHfRBCCffMCMRMfBfbRMbbSfSCSHCFCbFBbSBBFRFRHMHRBFBBHFBRMCHHHBBbHbSFF#
#bRffBHHFRfMHfCBMRfRRRHRBbbfHHHbSfHMFRMHMBbRRFCMCBBRFCRHRSfbBHFFMffFbCBRSMMSFSbBbRCBBbHBBMbFfRBCCRb#
#SSfCbHRHbSCHfFBCFMfBCRCRbHMSHMSbMfbBBSHHfFFMBRfSbRfMCfMBFFCFHFFCSHHHHMfbFbFSFbbRCMRFSMBbSSMRBHFbMF#
#RfRfFHSHBMHFSHFSHbbRFHCRffMFCFBCbbBRHHHCfMHRCMbFfFSHMFFBRFHFMMSFbFBbCRSBbfRMHFbCMMMFCFRRBbRbbSSMHR#
#BCRFSRHCHCSRMMMfbFFHHbBFFRMSRCSbbfRHRbHSCCCbFFHCFFfMSBHRbBFfMCffMfCBRSfFRCFRHfRCHbRfCFRbCCHfSfMHFb#
#fHFBSBbBHFHMbBfHbRbSRfHbMCHRFMRMfCBSSMSRMSHbMfRfBCCMRCRCCMSHMRHbHCFbCFfRFFffMRfBfbRSbBfCCbfbBbCbFR#
#bbBCBSFRCRHFBCHRSCfCfMCfCRBSbCCMFMMfRMRbCbSHMRMFSbMMRCCRbRHFBbMbSSBCRfbbfBbCFFBbbbBHHRMSBCMMMFRCMF#
#RBCHfHRRCMSfHMfbfMHCbHFRMFSfHbHFFRRBbMMbbCfCHBMHRFFFFCCHBBSMMBHBFRSSffCbbRRFFBHBHMCHBRbSHFBMMRfHCH#
#SbHbSbRffCBRSbfHfRfbSCSCfFbBCBMRMFCBRMbFBRCHRRMfbSCHSRHbFSRRBFbMfHSRMfCRfSRSbHfCfCCHbFBbFbRBbHbbSH#
#CRSRCMBRfSFMBbfRRMFSHFBBSCHMbfHSbHCFSRHfSFRCFMBBRbBRMHbSRRRCFMbbRMCBRSbfRCfBbMHRffBCBFCbFFfFMRCSCH#
#MRBMRHFfMCBSFfFffFCHfRHFRBSfFbMRSHSSFSMfBRBbbRfbbfbMFCMBRFFMHBMbfbfBMRFSFfHHFHBBRSFMSSHRHffCbfFbfb#
#bFbSCSBRFCbfCBbMBBFCfFfBSMfRffRbCSMSbMBFbRBFfCHFbHCRFFHRbSFMFCBHfbBMbFFFRMbFFHCbRSSMfbBfCMHSRffFHR#
#RBSSCSHSFRfHFbFMSBHRSFCCHBfMMHbMbbHFffCMMMSSRbHbRRSBFbHCMHbSRbBFCbBbBbCFFHCRbSSBHSMHSCMSCHBbHBRFRS#
#bFbbbBFCCMHbbSRCbMMHBfBFRRbMHBHfMbCBRffCCSBHfMRFFRffbSbRSMBMMbSMRbBFRRfSHHMFSHMHCRMRMRMSFbHfFFffbf#
#BbCFMRMRbBHHfBMRCbFfFCCBFMbfFfSSfbBSBBSCFHRHHSfbfRCHHBBbRfbSfCRHSbHbBFbCbFRffSffbMBHCSCRfSbFSBCRbC#
#RfMHBHBfMCMFMbSbMMBSfHfSSSFCBFHbMRHBbbBCSHBBfRFBCRMbRFBCfSRbffbCFSSCSFbCMffCFMfbFSCFSRbBCCBMBfSSFM#
#MCCCSBCFfRfbfbFFfBbMBCSfCBBBRHbRfHHMfbbFBfBfBRCFfFFCbHBRbbCHSCffFCFBFfMHbRCRFRBHBCBRCHSBSRRSSHHFBC#
#MSMHFfMbHffffBbfRHRbCFSMCRfbMfbSMBSFRfHFFMBCHCFRbHSMCHbbfBbfRSMHFMbBffCMCFHSHfCHRBBBCHMbBRMfCbSSSH#
#bCMbSbRFfBCRHFbfFSbSFbHbSHCCffffMHFSFMHRHSCCRMBHHFCbCRFRbSBbBHSCBMMBHCSFCRRSMFSHRRFSCHMFSHRfHFMbFM#
#CbCfBMCfBCBbBHMSCCCFCRBCRCbFCBbffHBMRCbMHSSfMCCMfbCSRCCMRCRCMMfRHCRBBbMRRbCSMMSRHRSSBMBCFfFRfbFSSb#
#BRfSCCSffffRBCHHBBfSbBMbSCCbFbSCCRHCfMCRCBHbRHRFBRfBRbHHfbbffFCRSfBHFCfbSCCSCHMHMHBfHMCfSRBfSBbbMf#
#RfRBbFCHMHSbMCbbMHBBFbMRMRBSCHMfCHfHFMRfffSBFMMSBFBMBRFSHMSBSfbCfbfSMMMfbSRMFHHMCHBSHfBMBCbRFMbFbH#
#fMBbCfMMbfHMSFfHSHFHSFSSbfHRBBMCHHBBHRSbFCCCBRFFbRRMRFCSfSBMCRSHbFHFMBFMSfSfMRSMHBFbMMbSMMFFCbCRSF#
#MCBbbbCfSHSFbSMfMFBbBRSbfbHCfMSCCRSFfBbMbSfBSbbRMfMCMRCfMFMRMbFffBfFFRCSBfHCbRbCCfBbMRHCHbRMHHHCHC#
#RCMSFRCCRBSFSMRSbMBBMHSHffCfHMCBRBCCBCSbFCfMCbbBfCBSCSSHMFCBCCBSHCCCRSfHFCRCRCfHRfffMMMRFMbfBMFfCC#
#bCCSbbMfBSHCCCBCCSFRCRBHCFMRRbRFMHHMBBRHFCHSFMBCHBFbRHBBMfbSFSbbfSRbCCFMSMfSbMFSbMHSCfbCbFFbSCSRMb#
#MMFFBbRbHRfMCBCfBCfMCFCMSSbHfHRBFfCFHCBHMFRfBSFfHbHbHRCFbBBSbCSBBfCHfSMBFFFCHCRSMSfRRHCBbMfRMHCfHB#
#BBfCCbRbCRCHMFHFSfFFBHbSfMRHbCbSSMMHFRfSfFbfBRbCFMFHfCbFMBSRFbSRBSbRBFfSCMbHHFRBBbCFMSCFbFCCfRbBBS#
#CFfMMbRCBRSRBFRbRFSCRFbbbfCCSFCMMBCfFHFFbMRMSCMRMBCBFMCHSHfRRHRbMCHSfSBbSRHBCfHCfSfRMHbRRMCBHBHRSb#
#MHBbBbRMHbBHffFHCbSCFHRMfbMRRbFFBSHfHMMFfFbbMbSHCHBHMMbFBHHHSRbfBBSHHSRbRfHCFBBBHbRfBSbMfRCFHMHRFR#
#HfbfSRRCSfbSHHfbSCMfHFfRSMSHBSCCHCHbSRfRfSHCMSHBHSHMBHfFSRfSCbfbbHffFFHHRCFSbMMBBHSFSbBMFHBfFfCRSC#
#bHBFMSfSfFMRSHBRbCfCRBMFFCSfbCbfRFFCRHHSSHBSfCHFHMRFbRFHHbRfRHSHBBSCbHFbMfbSfRSBBCMFCHFCMBHMMCBFRb#
#bCMHFFbfbBHBHCbMCMFFbHBbMFFCHCfMRMfMffHCFBMBRRRbbFBRBbRBbbFSMHfCbFCbRRCMRRBSHSHHHbbSRFbSCHbBRFMCHR#
#FSFHFSSSRMMbFBHffHRMHfbHRBSFHMMFfFBMfHFFHfCMBfCHfFbfCSRfCCRBRCBHFSFBMFHSFRSRCbbMHBfbSfHBbBMBFbfbbF#
#SbCfffbBMbFbHHMSRfHFFfbBBCHSbMFFCSFRBBSMbSMSbMMMRCbRHHRMSFbBfRRSCBFBFCCfHffMbSRMBCCFHRCFSMMRbbHMSF#
#HSCCFBBSBbFHHRCHMFRBSRFCBfRRbBSFbfHRbfBHHfBBFSHRBffBSRMRCSCbFCfFCfMSBbMFSBBMHMMMfFbSMbFfCRfbBMfBMM#
#SRFCRHRHBBBMRBMbHMSMMMFCHbHSHRSCFfBSbBRMRRFCBHbRbCbBHFfRSbBRbMRMSBCFHHRBfCfCRSMMfBbFRBSMbSCFbRBbRH#
#BffMHBbSMBMBMBBBHbMBHSfHBMfCBSBbRCHHMMbbRHffSBbRMRBbRFHCHRfHBFFSRfRBCCHSffFfSRbSBFCCSMMRMHBBSSCHBS#
#HfFMBMRRCBMCFBMHMHfHMHfRRRMFCRMRFMCRfMHfRCffbFSHRfbbFFfFMMfSSMRMRCCMFBbSbHfSCbHMbMCFBffFSSBBbBCbMF#
#fbbffCHCFBMCMBRMfFRfRRbBFSMCbbHCSHMHBSfSBBHbSBMSFfRbRBMMCSRBRBCMRFfBFRHbSbbFMHSfbHbfMFSSMFCfCSbbfR#
#fRFHCfBbBMHSRSSHMFHCMMCCRbHRFCCfHbfHRSRRMfBbRMMMFBMbfRFCbCSHRMMfbCSBFFMSfRMSBRCFFSHMSRHRMHBFRRFSSB#
#CBMBFFfRbSbRffHBRBFBfHCbbMfHCMbMbfMMMBbbbbHbSbbFBbSCFMbHCHCBHCFSfMFbbbSRBBfRfHfCFFfCHSMHffFHFfMMFS#
#FCbRCfMSMBCMFRRSfBHSbCMFBSBSbSbHbSRBCFCBSBbHFFfRHbRbbfCCCMFCHbFRRHCSCbBCSfRBMbfHSSHbfHfRbCBSCMRFBR#
#RMbSFbffSfBbFFMFRfMHSHBRSSHRHCRCRfFRBHFRFMfFRFCHMSCbbBFSfRbMHCFSHRbRbCSMFFSCRFHbCRCCHMCBSCMfSbCHSf#
#BBRFfFbCFRHSMFFMRBRFbMBSCRBbCfFCbCBMSSBFFRCCFFSMCbSbMHSHbbCMRfMRBCBBSffbCfMFBfFbfRRMCFHMbRCbbSbMfS#
#BSBHHHSCMBbMHfSSfHBMSSCbbMFbCfMFfHFMFbfbFbRMfBbfFRHSRMfBbfMBbCFSHbSRCSBFCSMSBHSBbBRRRBMBHbMRRBfHSR#
#HFfSFbRSRCSBbFCSRbMSMMbSSbFMCRfSHbHfSRHbHCMSHHfbSRHbFHbFCMFMMMSFBRfCHbfRRCbRHSfHHFSMMfFBSfMfFRHFSC#
#bRfRCCBCHMbMHRbMCFBRBCRBBBBfBfCFfbBfRCFFBSRfbFBbMBMSHCRSbCfMMfRHCSbfFbRMbfSfRCBBMRFRMfCMMbbffHfMFB#
#FCCHRFCfbSSSCMHHCBSRHCbFBMbRBFFRCfCbCfSRHHMRMSHRMbSFSHRMBCHRfCBFBHBbHbRCfSHfHfSRFMRHHSMHCHBfCbSfRH#
#HCBMBFHHBBSRbHffRRSMMSRMHRCSfBHMFHbFBFCBffSRSBfFRMSBSbMbMfMCffMBSRBCSHHFbHFFFfFFFfRHSMRHBBRbSCMfRH#
#bBRCSRRSMFFHHfRBHfFbMFRCCCbBbHBHSCCCbbHSSRfSFFBBFCRbbSMCBHffHRfMCBbHMHRfbBHBBbbbHBfMfCCFBRFCHMMRbF#
#fBMBRCHRHMSSHBFHRbSCBbHSHMCfFbHHfRRCMCBMRBCRCRfFMSMFbHHMCbbbMSFBMfCHRRRMBMHFFfCHCFbMHfBCHBMRbSHRbS#
#FbCSfBMMfFHRbFFbSMMMfFHbMFHMCMMBHfSCbHbFRCRBRMfMRRfRCRBbRfCbBMBbHSfFMMHbRbRHMCMHFMfRMCMMCMbSFFFFFR#
#MCbCCHBCSCbSFRfRFCFbRfBSFfHHMCRbHbSMRMFHfSRRffRFMRHfSCSMbRfCSBBBFMFRbCfHHBSMBFBMfCSMFBCHSCHSfCMMFM#
#RCHCSfBbBbRMRCMfFbRSSBRSRBHfSbSMMffMRBHHCSfHFHfRCFRbFCHbCfHFSMBBCSbMHFSCfbBSHfHMFfSSSMSCFFHbSRCBBM#
#SbCSBSBRRBMRfHRbSCBfSfRHCRRHMbBRHFCMFHbSbMffMMCBbbbSFHMCfbSBRbMCBSBMbRBCbbbMSBMBFHHSRHCRRSBbRFRHHF#
#CbFBMBBFSBCCFHHRSHFCMCRCHSHBBfCbRHBHSMRMHRbCRFbHMCBbfMBCMCBFbHRBMFSHFHffCSRSCfMRbFSbSBBMbRbCSBFfBC#
#RHBRMfBBCSBBFSHfSfCFMMRbfMffFFFbbbSSFSRHRBFRfFRfbRCbFbHfbbMHfSRCHHHFBRRRCbfbfCFRHCFbfMfFBSMBfCHHCF#
#RFSBfffBRRfRCMSRHFfbBRfFMSbCfbRfCCMCFSHSfFMMbfBbFBfbMCCHBfFfSMRRFBFBHFfBSfBBBffCfFMSMMMffFbbCFRFSF#
#RMHFfRCMFSfbRBRCRRSHMFFbFHRfMCMBfBFHRRCFHCbfCSMRFCBbBFRBbMBCMRHSMSRMFBHCFfRMCMMbHbSFBFBCBBMHfHMFRC#
#fRSHMbRSSSHBMRBbFMHBfFfFMHfCSFbfbBHRfSCFMfbHbMRSSCBFMFBBFCbbfRfSRCCfHSbHbCSMbbFMSMBBFbHMBfSCBHBMSS#
#RbFbRfMbFCffbSRbfSCHfSSBHMfBFCbMSMFMFCHSbHfbMFRSSCCHHCBFBfHCBMbBRHSMHSffbRRFfRfFBMSbHBfCRCBHRFHSfS#
#BbBHBBHFSBFfFSFMMSbFCbMbbCBFSBFMMHFHMSRfSfMFRHRfbSBFMFBRfBFBCBBfSMFSCMRFBfHbCfFbFFMHCBfbFBRFSHfCMR#
#BBHBHSRbCCfSFHMMCRbbfMCRFfMCFbBMBBRSHHfHfSfMHfSMBCCCHBSbfHffFBRbBSbRHMbHBSMHHBHFMHbMRMMMBRCHfFMFBH#
#fCCBHHbMCbfbRBCSMRbSCSBfMBMMffRFFBMfSBSRCHFRHFbfRRBbbMBSHfBBBFRSRRFRSHSHFRfbRRFfFfbSbSfSBfBbbMFMfS#
#SMMCHBMSbBFFRHSbFMSSbfbFbFSFFBSFfCFbFSMMHMSFRFBSRFHRbMRCbCSBMFCHHMCfbfCFSFFbRFFCMbRRbRHSHMbCSBFfCF#
#BBBfCHFbCFFHCFMBBbfBMFBMSHCbSHfSMRBMRSRHSHfFfFRfFfbSSHHHRMBSbHBCCBFSbfFSHCCRHCSbCCbCSMBRFRBMbRFCHC#
#MFBfBfMRRBMHMHHFfRRFHMSFbHRHBCMFSBffHCfMHRRFBbfCCRbbMRHFCHRMHRHMBHBBBMfMCbfBBMHMCRSCRHbHbRRBbbSBFC#
#fBbCBRbHHBFSSBFBRHBFHMFSMBRFRCRMbBMSSMRfRFSFCfFMBFMBFHFRfMbfBCBBbRCfMMBSfSRHMSSMFHSfBfCSMCRCFbBHMb#
#HRSHCbCfHRRfbCRCFFfSMRbRBbCMCfCCBFBMbCHHbBBBCfBSBbFfBSCHbFffFBfHfHbbSBSbFbfCSffHRRMSRSFBBSSCMHFRRH#
#FfFMRHbbFRMHCFRMFFHfbfSRRbFRBbCFCBffSFFRBCSMCRHMRHMFMRfRMbBRfbMRMFCBFCCBfSMBHCFCHHFRFCSFCHSRFFbBbf#
#HHCfbfFBRCSSRSRHbfbFbSMBHHHfSBbRRBHFFBfHFRMRFMCSRBFBfHFCFFRbSMfSSHbFCSHfbbRbFMSRBSBSFMBfMBHCCHCbFf#
#ffHMRSHfFCbbRRbHfFCFfFffSbMHFBMCMFHFSCCbBfbfFFRRbRRHHbCMfRBHCCbBHSHCHRMSCRfRCHFSHMFBCbCbCHSCHfCFFf#
#fHHMRHHFSMFbbFMfFHFRSRCbfBHSBbFfFBRbCbHBHMBBfRFRfbBbfRfFSHMRSFfBRMRCBBSffFRfBRCfBHFFMBbFRffBMbSRff#
#bRHBHFCCbCRHCBRMBFFbHRfMHSffRMHSFBFBFbFBFHSSBHFCCMfMHHHHfHbSMRRRFMBCMMHSbbbMbfBHRfbSHHbbFSFMHHBbRb#
#BFCfRFMBCSbfMRbMBFBFCRHCCHMBSfMSHHRbSSFMRFfbbMHCMbSFHbbMBBMMBfbbHRCSFbCbFCMBffCHRbRRCBRFCCBMHCFFMF#
#fMbfFHSFMffSMCFCFBBBSBCSRCFMFfSHBfBSBBfMRRSFbFRMHFSffFSbfMCRSSbbSMBbFHSbFMfMSRMCMSHBFRbCMMCRFCMFfS#
#SfRHbBSBBbFfBCCffFFHFFMRHbCMfCbCfCMfHbFRFbHBfFfFbFMMSFRBCbCBBFbFMHSFFbSFbCFfMHBBRCHCffffMCFFHfBHCf#
#FfMCbRHBRFbSRCFSHFRMHHBbSBRfbFfSbCBBBbHBSCbFHSSbBHbHFBfSCBFffMMSBRBFRHRSHMfHBMRSMBFHBRHSFfHfSMSHHH#
#BFHHCRSbbSffbSHBMSCHbfRMbHCSbfCMHFBfbbSRMBBRRCHBbSBMMMMFMbBRSHCBRHSMFFMCCffFfFbSBRCfbbSCFRFCfbbbFB#
#bfRSbMMbbHMMFCMbSSHRfHHfCffSfMRSCSFfCHBCbCBfFbMFBBSBFFFBBBbRRfBSbCFHRHHMFCbfCSSSFMbFHFbBfbfBSFFRHb#
#FFfFFRfMHCSfCbCfFHfCCSRbHHbbBCfSSBFCCBRCCSMfCBfSMRMBMHbfffHfHMfbFFMHfSHRBHMMCMfCCCbCbMFfBbBfMSMfbH#
#MHHFRFFMSCRBFRFbRbfRBCfFSSMBMBMHbbHBFFBCBCFRHSfMFHSbbHCBBCMbffSHCSCSSSfbHfMSCHMSSfCSbCSbFHMBFCCFSf#
#BHffBFMMMRCHBbBHfMfSMFHRRfRFFBMbfRCMCRSSfCRHCbbFRMRFCBCFFMHSMbMRHfBbRfHCSbHHMbCHCHMbffRbffRHMffFbS#
#bRHRMCRBbMMbfBMMbHfSFFSbHFSMFBbBCBbpHHfSRbMCSCbMMbfBffbRfHCMMSRCFRFMbBMbMHfCHffMCSHFCfSFBMFBbRfHFM#
#SBMbFfSCHHBCFBbMBRSMHHHCfRSHbCCRRCMFRSfFCRFRffCBFSCCfSbCMCSbCMHCBfHbMHBSBMCMFBfBSSRFCRfRBfSBMCfMbH#
#SBfMFMbFHMMCHSBFMHCHSHCCbCFHFBRRMSHMHSfMCHCRFBbRfBCBbBFSfRRSFCRSSCCHFfMBMbFbBRBbfbbFCfBBCBMBfMFFRC#
#SfHbHBbFbbHbBCbBbRbFMBHfBHHRRRRMSBHHRFFFSMbbMRbfRFRHFbBbSRHfFbHSCRCbSSHMMRBSRMRfCFfRCBSCBHFRRfFbCR#
#BCfBFRCbSFCHCfSBSbFBSSbfRMCMHbBHbRSHRFHCFbBSHCfMFMCHbSFCMMMSfMBMRCFCCFCfSbRBBHfHBRSRCSSSCRBRFbHMbB#
#MSCMbMHMfBBHFHMFbMRHFBRMMRSSfHFCHfRCSMbHFMCCRHRfBSSHCRfbRSfRRbBMSHRMBBMHfSbSMfRCbHFSHMHRBfFMRFSbHR#
#RfRRSHRSRSMMHHbfRbbBFCMSMFBCRBCCCfCBbBSSfRbBCfMbCBCHFFbCHHMbMBMRHFBBBRCMCCbHfMSCHMSCCSRbCSbFCRbfMH#
#MbfMfHMBCCHHfRBSfCRSBMfRbRMRRSBRMHfBMbSHBBFSMMbBMFSbMCBbFSHBHHCFFCSHHHBRbSbFbSCSBRFbHRBfFCFSMMSHSH#
####################################################################################################
