####################################################################################################
#RFCSRHbfffBMFHbFFFFbSRMCBCCRCFFFRHSFHSHSHCbFMMFBSBFbCSFMBRFHMMMBCHMCCbCfMRFSSbbHfSbMRRSHHCbRCBCMfR#
#CBHbHBRFfSCRbFMHSSHHffRbfbRfMFSFCHCFFHBbHRBFFFCHRHRbHCMffbMFFbfRSRBBbbMMBfFHMRCSfSFRbCBRCBCbFbMfRF#
#SCSMCRSCMSFfbMCbBHSMCbFMbCCHSfMFRFRMMCRRFCRbMbSBbRBRSMfCFfSCBRHfBBBRFSfRFBBSbCCbMfRCCHFMBbRRHbBfMb#
#BfbRFfMHFBSbCRHSfMCSbSFffSFSbSFCSSCBbHHfSBbCHMRRSRfCBSSFfHRfMRHHbbRHMFHCSBBSRSbfSfBSRbFFMMHHbbHCfF#
#SFCSFBfHMHRSbRMMHfMMSFRCFRHMFHFSbBCbSbbfFbRCCBBRbCMbBfBbHfCfbCSFbHMfBMRSCHSSFFSCMMfFFbSMRBfMBCfCBH#
#FRBSRCCfRfSCFSFFRMMHffFMCMfFMbMCfbHFMFSSHRMFHHfCbBFRfBbbSCbfSBCHbMCMCSSMSRMCSBFBffbCfBCbRbFHMRfbFf#
#fHbRbMSSFRMSCMRCSHCMFfFfbSBBHbHSMSbBbBfRRBSCBFRfFMBBCCbRfHCCRSHHSFHSRfRMMMHbfMMfBMMMbRBCRHBbSfMBbM#
#fBRRMBSbCCRbRfMCbFFSSSRBMBBCfBCbMbBRFFRMbRHCFBRSFBBfCHbffbBMffbRFfSHMMMHCHRHRCCfHCMBHSBHBRSSBHCMfC#
#CHbFSMBCfMBSMfFSCRFfCSRRRFBFCSFbSFfFBbMHfCfMMfBbSHRFFHRMCfFRMFbSHRHHRCBRBMRbbCFCfBHFFFfFHffBRSMSSH#
#RCBMHMFRbFSMfCRRMHfMCHRSfSFCBfbSMfMfMfCbRSCRSHBHMbHFHHHHHRMffFSSHMFHBBMFFRFRRBbbBMbRCCFHCCbFHfBfRC#
#CfMFHbHBBfCbBHbMHCMRbCMbRSSbFfSCHbbFBRfbfSFRRbSCBSRMHMHFfFHBRHMCCbBFfRFHMRbFHRSSFHBMfSCRRbRfMSSMCH#
#fMHMMRBbHCbSHCRMRbfHFbSBbFSHSBCBMRFHHHMbMFffMfHHfSHMBBBRRMMBbfMMFFBHBMSMBCRRFfSFBfMbbSbCfRSbfSfHCB#
#fMfSFHSHRRMfSRSRSHbBMMCSCCfRCSRbHSRfFBbSHRMBRHCMMMfRffBMMfSMbBHSBCSRbFbSRFHCFBSRCBSBfSCCbBCfHCFMMH#
#FCfbMbCSHbBfSSfFSFFRfRHfHFCBHMHBfFHBHbHFfMBfHHFbbfbHBBHFHbMFMCRHbbBHRCfSBSbMHFCfHfbbBbHBMSMbFBRHMf#
#CSCRBRBCfMMMRHHRBSFHCfMRRSFRSCHHBbSFMbRBFCCbBRfMMfMRHbHRfRSCfMfbFBRFCBfRfRFCbfMFMFbbRHSHHHMfHCBSBb#
#MbMbCHBbFHbMMHHHfMRSfSSMSHMbBfCFfbMCCRfbSbHCHRBSHHHfBHRHbFBHbbMfpSMfHFRFHfBbHRfRRMfbMfSBFSCfCMHMFf#
#HHMCFBHbMRSbSFFbSFCfHRFCFMMCCMBHFFSbSRfRBfbCBSfRfbSBfFRBFRBCFCMMbMbMbMFRHBBFMCSHMSSSMHCRHBHBSSHRRb#
#HbFRCFSbCBSBRSBMFfFCBMCSfHFMSMFbRbSFMMMHCfCMMSbHMRSHSbBCbSfFHbBfbBFFbSbfHfRMCCMFRHSFBbCCCbCBbCfMCb#
#RBSFfCCCSMfBCSFfbRFCBMFbfRfRMHSBRHCFbbSHCCHffCBfCHfCFfCSRCbRSbMRMRfBSBHBBBfMSCMSFBRSSFbMFCSMRRbHFb#
#BFfMbBBbbSbHBBHMCFBSFCfFSFBfbCSHHSFRCBRbCFCbSHMfbCbMFHRbHRCCRMfSCCBSCCfFfMMFFSbMFfRBBbfBRRFFMCBHHf#
#CSBBRBBMSfFSbMMBBMbHSbBfBMHSBFbbCfCFRfFbRSFfffBFCMFMRRMBFBFMRMMFfMRMbSfHBHFCfRRRSMSfHMMMRBBRHBRCSM#
#MBHCBfSBSfCMCCFFbfMMbHSBFHSfBHFSfHFbHCfSHMMHRHfRFFRBMSMMbSCRbFbRfbSSbSCHbCSFHBMHCfRMFCRMMbSBfRBMHF#
#BbHRbHFffMSFMHMBFSBfFbbSbRFBSHSffSfSBRfbSHMRbBFHMMBHHHBbbFRBfbBMbCbMRffMCfbHMfSfffRfCbfFHCRFSfHFfF#
#RRfRbMbMMSCBSCHbFRHMCFfFCSRRBSfCHHSRMFfbSbffCbfRMRHFHFSHFRCCHCMBCMHCRMBHRFfBRbCMMRbSbMCbbfSffFSRRC#
#FCbRHSBfMfRSCMMfFCMMfbffRFMCSSbfBSSBCBMCRMfRMFCSbRbRSFRSCHSBMBBfbbfCHBRbRFHSMCCHRSFCMHfBbRBMCMCbSH#
#CFBBbBbCBFFBfRfMRMMFRBbRRCRfHHHMBCbBbMHRfRBfMCSMSBbfHfbMHSSFCffBRMMCFfMSBBRSFfRSfBfHFRBCCffFHMSRRB#
#FFbCBHBMHCRbBBbRBMfMbRMSRRBRFfHCHbSBfRRBfCSHFBbBMBMHSHbbbBCSfRBBRRSHbbFMMFHBfSMBSFBRSfbSSbHfRbFbSR#
#fBbRbSHRbRfFSbHBSRRSCFMRRCCSCbRfBMRfbFMMFSfCBfBbfCRRHBbBffbFbbBSCfbCRHSCCCSHFBFFfFCCfCBBMSfbBFSBHM#
#BSFBFHMHBRMSRRFMBRBHfSHBfHFBfBCRBRCCFMSCSFMSfCFMSCbFCMSHFMbFSBbMRRSMRCFFbSfCSMCMbFFbFSCbRBBbMMbSbb#
#CRfbSFFSffMHCRbbSRSHMFBfMBCFRSSbBbbSHHCBRSFHbBbHFFMSBHfBMFMMMMHSRSfBHMffbMSBbHfCfFbBbHHRRFMBCFHffB#
#fRCBCCMBfCbFBBSFRfBbCMFffRfSSBCSCbRBCBHRHFHCRBfbMMMMRBbHRSfCfFbBFFCSfRSbBMRBCCSSffBSCMCFMSMRFBHfMM#
#FSBSfSSCHbHbRbFCfSFCSRFBMbHBfMBSBCCHRCMbHHHbRMFCfHbBBRRCRCSFFHSbSMCBbRFBBCCfMRMBRHSCbfbFFFFbCRHFSS#
#fSHRCfMRSbRSbCFMSCMFSMMffMbMHbFHSHMCfBBSSRHRSMMCFBSSSMRfFMFSFbFBMSSHbbFMSSfSbMFRMSCMMSSSbFBRRHBfRC#
#RBHRHbBFBBFBMBHFfSCRMSMbMCHCfRbFMHFBFFSBCFRBFMfSRHfSRMffHMfFBBBRbBHbMfRMHBRSSSSCRbfbSSffMCBHbbFFFF#
#MSMBHFSMfffCBMHbSbHBCMfBbHRRFRSbHMbCBbBSfbCfBfHMFCCMSFFSfBSbBHRFRBbSbbCbCFCHfbfCCfbffFRMBRbHCFbbHM#
#bCSHHFbBMHfFbbBHSMHFfSCfHRMRHfBRSbCCCbRCCBbRSRFSCSFMHbFMSBMMRbMMSbbfSbbCfCMRRRHfbSHFBbFMfBMbSbMfBH#
#BfHbRBFFMfMBbRRBRMCSCFRHfHSMfMBCFRfRFbFMfRCMbMHbFMBfbSHMCbSbCbSFbMBfbBbMMMRfCBCbCMMRffFbBBCBBHHHFF#
#bRMFHffMCMFfHffHMSFRbFRbFHbHMbRHCBfFHRCHSRbRHBCBBfSMbRBFBBfBBSRMfBbHbMBBHffSMbBMRFbfbRHMMfMBRHfMBF#
#MfFHBRbBBFbFSBFbFBMbRCMBCRRBHRHFRbFRRBCFfbRffCCMSMHFBSbRfBCbFHbMFHfHCRSbFBMFSfFMCffHBRMbRfFMRBRbHf#
#BFBSSBHHCMCbfbSbMbffHfffCCFHSFMSCfMFHSSHBRSMRSMFRCfSCHMFCFRbbRFbRRBSCHHFMCbRfSBSMffRFMRCfSMSRCCbFF#
#MbMRHMFBSBSRSbffBCSRRfSCSHFbCHFSSSfFMFbHHMbBbbbfHHHHFbHBBCfRbBRCMHbFCfHCHMFCbFMbRMFHCSRBCSFBSFFMMR#
#SBHSRRbffCBbRHMSFfCMBMCHCSSCBRSRRHRRfHfFbMHSCFHFCHCCSSfBFMRFfRBCbCFSMBCbbRSCffBBMfbBSRbMRFCMfCfHFR#
#MSBCFbfRFbBMSBCCFRMSCMBbfbSHRRFfBHSBFFCCFffBRHSSbBFCfbbSFfBFFfCCRFCSfCMfHBHBSBFMBSMCSRHCRCFMRHfRSf#
#CFMFbRFCSBSBFBFbCFbMRBHBMfSBBCSCbRbCCbFfMRHFCBFFSHfCRRCbfHfMBffBCHBSRRBFMFffSHHfBCBbFFHFRSfSRRbFbS#
#CCSMbFMMMbRHHMbSFSbHFffMBFbFBCfHSFBHCRfCfSFHFMRbFBCMHffbSRFCbbFHMSRBHCfHMFSHSHRBHffFBFMRBBCCSMCRHM#
#RMbbfCbFMHRHbMRFfHCFbBbSbMFMbBMFfCHffMRCSHbCCBfFCCfffFRSFCMFHffSRRfHRFBfMFRCfMbMHRRSMRfMCBSBCSRRBM#
#MCBMRfMSRHHRCCbbBSHBHffHMFFHFFBFHCRCSfSHSBbMbCBBCfHRSFMBRHCSbRCRHHHBSHMFMMFRfSfCRCRCMfSHRMMMSCFCfC#
#BRHMHCHBRHFbRHCCCSSHMHFbHHHRMCRCRCMSBHHRfFSRSfHSbMbMCFCSbfHRFbSHMFfMBbCCfFMBffBfBFBRfBBHSCFCbSHFff#
#CBFbHBbSFFbBSRfBFRSHBFbBfFFbRfCFfMbfSMRRCCBBCbMBbCfCfFBFSHbSBbSHSSSMFRfHFHbHBMBbfbCHMFMfSRRRMbfbFF#
#bMfCFBHRCCBfSfRBBSRRHBFSRBHRSbSbCHCbRCRHbbCfFRbfSbRBFfbbHfBSMRfBRMHSCCHCMbbRCbFRSRSHbbbHbRMRHbCSRB#
#RMFRRMHRbCRCBFbMHHMRRRRSfFMRCMCFCRRMMCbMfCBBSHBSFSFRFFSffSRFHCMffFHFHRRSMbfFFCfSHBfBFbSRMHRMCCbHfb#
#BRRHbbRbHFCFMfHRfbMCBFHfRCHHMSMfHfCbHfHFHHRFMMbHCbFBCFMFCbfFMRBHCCbHSbBCHRBCBHCfFbBfFHFCBRCbCFfSFH#
#RRRCCHbMSCfBbCHBSFBBCSFffbSMFMfCSHRfBBSffFFFHSBFfFMCbHHSMHHMSRFfRRCRSbBMCSSBbMbMCBfMbCFSFMCfFFCbfB#
#bFBSBCMSFRMfbMbSRfMHBSRBbfBMCCMHFCBCSCCHRBMSBfMBfRSfFBHCRfMBbBMMCBMFMbCHCRfBSFSCbCCSBbSfHRBHBfMCHR#
#FfMSCBRCFBfSRCfFfHHCFbHMbSMbBMBFSBfbfRBRSHFMCBbCCfHBSHBCbfMfRMHMbSSMMFbCbHMFCFCHHCBRFSFFBCFbbCbbHb#
#BCHBHSMHHBSCRFfbFfFBFBSBSSRBSSfMCFRBbBfMRBFRbfbRbRFBSFbBbCMMMHfFRBHfHSBMRMRCRCFSMFBbfCRfHfHHSMMFHM#
#BHHSMbBMMfMbBRBbFBCBFRBRSFRSCHbMBHMRRFfFRMMFRfBFMRCRfHfCFCCHfSbRHRBbSSfSCFBHFSSMBfCBSFMRbHHRRfFBFB#
#fCMbfMHMfFHbFSHSfHbRCMFCfBCfRFCSbBHMSRMMRCbMBHRfRMBMMbfCFffCHBHfMRffHRHfRbBfCBHSBFFbCbFMCCMfRbSBFH#
#fHCHMHCRRRCCSfMHFbRBbBRFMCSMMSMBFFRMCCHBfSfbFbSbCFbfBfbCHCCbfRBSFBRBBHCFRbRRbFBCSfRRfRfMBBHHMSFbFf#
#BRFMbBfHCRFCBfMMHfMCFCCHRHbCRRfbMBSSMfRCRHBfBbfBfSfbBRRFRRHHBHFRBBBbCCbRHfMFFBCSBHMBRffBMfMFFSHFff#
#BfRRRbCHfRHMMFSFRRHMbRCBRfCBfCRHCHCRCbfRbRRBCRfCCfSRFBRBfRRFFFMSBSHMRHCbFRBSBSCHFSHRRBRCBRffFbMMRR#
#CRfFCRRFfBCBBfbFHHbMHHBfMMfFHFHSfCFSHFSbSfRBCSBCbBbSSBRBffCBBSMFbBSMCbfBHRMRBCbCSHfFBbbRFffSFHHFfR#
#BFbSffbFRSFSfHfMbbHCFBbbSbCFbFBBFCSMfFBFCSSBFHfMfHRFbMbBbMbCRBSbffMfbMFMMBFBMMfbSBbBMfRCSMHBHfSbMb#
#CRHBMSHBHMFRHRMCMfbMSfFHFfCFffbfHBBbCBMbMSMMHSSMbMMFMRFHFBSbFCRSBBMSHHBCBRMCMfbRBRHFHBfCfCCRfRCfRH#
#FFBMHCCFfHRMRMBfHMMFFHSFBBMfHBHbSfFBSFRfRFRBHCbMFffCRFFbCfFBCFSfRbMFHCMbCSbMfRffRRBMFSfBbbbHMFCHCb#
#FHfCFffHFCRHFBMfFBSbMBHbRbbMfHbMFfHBfSHfFFFSFCFMBHHBRMfMFRBFfBFbBFCBFMFFMFRHfbMBRfCRSSRRFbHBBCHMRf#
#MBbbSSMFBFCMbbFSMbSSBSCFBSBBMFCfFCMSCHSbMSSFRfCBBMCfBfFCbHBBRRbFMHRbCfCBbfMSMMSBRMHSBFRHRbCRbMbfCb#
#FRFbCSfCCSSHfMbHSbHCbbSHCBfbfHHFRCCfbCBFfHMRbbRMfbbbfHFMHCFFMBSSRSSFMBMMRfCBMCRbHBSFRfCfRSRMHFHCSF#
#MBFfSHFFBHSRHMFfRfBSHBbCfBSHBbHRbMSCHbMHCBbBRFbBfFBfRRfHfRFHRbMfSSSFMbBBCCHMSHfSBHfFCBCBBHbbCBfCCf#
#CFRRSSRSbMCHSSCSSFRbffbCMHHHfFHMSSRMfBfMMHRfHFbHbFffbRBbbMCHFBMHCCBbCHbSMMCHBFSMCFSMHBCFSfBFRbFfBB#
#CSFSfBCfCSHMRHFSCfBFSHFbCMffMRHbBHSHHbFBfSRbfbMbRFHSCSHbHHHRBBRSCRHfBSRbRMHMFbHFSbFFFbFFSBMfRMMCRC#
#FRCfCHRfRHCBCSBMMSbMHHCMSCCHRBRBBCCFMHFfHfbHBFRSMbbFCHbfHbMMFSSSbRbbfFbBSFbHFHSCMHbSHHMbRCSMSRfbCS#
#bbbHMfBfSHBSRSRSbRSCMCfMSSHCMffHFFHBfHMSMbfCMHfBFBfBfbbHMFFbHMBBHCSFRFMfbCffSMCBSfbRSHFfFFHRRSMfFb#
#FfCMSSCHbRBfFfBMbHCRMHCSHBbRFRbHCSMMSSSfMRFCBFMFRfBfCBRCCFbBHbRSBFHMSMCfbBHfSSHFFRMRFbSHBHFHCHHMff#
#FHbHHMMCMHCbFMBBHRHBHBffHMHHHRHRCRMHFBbMCBFCSfCbHSHBHMSCCfCbBHFfbFRHCMSRMBFFbBMCMFRCBHfRRFMfHCbbFC#
#fCBFHSSBBSMBRHHSMRfFSFHSRbBCHMBRMHCCbBFRCBfbSCffRRfHfMCFCMSfCCMBMBHbBMSMHbFRSSMMCbMBSSMBHBRRfCFCHR#
#RCBRRbBBRSHRCHSBMBSCFCFRRBBBRCFRbCFfSSCCRFbRBFHRHBFbfFBSFBFFbHbBBBFfRCbRRbHbbMCHHHRHbFbfffCFfRCbBF#
#BbFRffSfBSRCfCSMBMHRHFHFbMHbSBfHHMMSSRSHSBBHFbRCfCSRCRCBMBRffRBFMFSSffHRSbSBFbFbHRSSBHHfFRbbMCSRMF#
#SHBfBFHCMHbSBSHFFSbbSfbHMHbMHSMHbfSMFCHFMbCHRfCMfSHSbbMBBbCHCffCRCfFRBRFMBFfRbBMfFfBRbBfFSMHFFFMHS#
#fFFSSMfMCMSfbHBBRFRMMHFMHMCbMHSHMCMBMfBfRHFSMCFHCCMFBFMCBHbfFSCbSFfHMFbFBSfMMMCCFBRMBHFMbbfCSfBCFR#
#bFCMSCSHHfbCfFHBRHHMSHCbbbbbFHHSRCMfCfHSFHSMMbCHMFSMBRMMHBbHbfbHBHSbRBbRBHHCfCfCSSSfSCBHMHMSRRbRRM#
#fbbHBFSMMRCHMHBbBBbBbCRBfHSMHbRbSfbMMbHRSbRRHFfBSfbfSBMHRMBFRCbfSCbHBFfFbSBBFMSSHSFFHbfFMFRbCRCFSB#
#HRHMSBFRCRMCbHCCbHBCFFRHCCbBfCBbMFCBFMCfCFbSBBRSSMHbBCMRBCHHCBRbHMCRHFCRRfFBFSbHHFSHHfSHfRfBHRSBBC#
#CMMfMFRCCfBMFFbRfCHFFbHbCHBMbMbbCHBCMMSHFSSMSFBbSBBMMRbFRbSCMFSRbHSffffSCRbRBbSfSSRMRBFHCBSHHHffbb#
#MBbbbfSbMMHHCbSbRCRRbSCHCbbSCSMFBMSSFBBMCMFbFMHbbHRbBSRMCBFHCBSbFRbCbBCRBRCRBMRSMMHSMRHSSffbFfSfHM#
#SRFFbCRSHbCBMbCCBCMMbCRRfbMHRfRFbRRbFbHRbFRMfHMBSCHbRSSRSBHMFHCHbBFHBMCBFRRSfRSBCRHSSRFRCCHCBSRfCM#
#ffffFMRffRBfMBSFHRFCRSbBRRMCfbFMRHfbHHffHfCRffMMBMFRMSMRMMHCRBFRFFRHfFCHHBSSFBFFbBHMBBMbHbSfRFRbHS#
#SBfFRFBRCfMSbRFMBMHRMHSCFMFfRMSCMCCbbBHHBRfHMFHHMSBMFRMHCSRCFHMSbCSFRbMbCfMRSCbFMFBFBSCBbRBMSCCMHB#
#SFbCRbfHFCFRHFRfFBHFbRBRCFHSHSFBBSRBHBSFbFRFbBbHFFCRSHFBFbHSSHMBHfFSfRBBSbMBMbCHbHCFSbbSbBbFRfHffM#
#ffMMHSFbSbRRMBBbBfBfHHBCbCRHFHCSfSCRRMSRbSfCMRSMBSSFRSfbRCbFBCSSMMMbFMMRBFFCMRRRRbBfBBHbSBCHMMMFHb#
#fCRSbfHfRbFRFHSHMCRMbSHCbBbRFHHFCfbSRRRfHHbBRFRBHRbMRMMFMCBfCRMCHFCfFfHFRBHBHRfCffMbRfFFRRSRSHSBfb#
#CbBRHRbCBCBbHHBFSSSCSfBRfSBSFbRCMHHRHRBSfMMffHHRHfMHCFFHffRbFSMfRMRbBfbRSMHMSfMSFfbBbMbFBFHBSCCfCM#
#bRSHHSMbHHHCBSFfHRFFMHCbFBCHSHCHbRBHCBMRfRRBbMBRSbRCCFSbBfbCSFfMSSbFBBFbMbfbbFCbCFRfFSSSHCSBHRRbHF#
#CBHSSSBCBHBBRBFBRFCbbCfSSHfMHMCMffHSRRbfMCbFBRHFCRSfFFbRCCbBBffCRbSBSMfbSFBFfSFBFbSfMCfbFSFHFBCHCM#
#SSBFHBSHHRfbBbbMCfBfRfRSBbBfHBbFFCfSFMMBbMCBSfbfHbSCSCfffSFRSfBbFHFBbCCMSRfHFfbBbFbRHCBRHCfSSSFCCH#
#fHFHFBFMSHCbMHCRCbbSMBCSBCRRSRCSbCBSfMRRHBbCSbCHCHfHbHCSHSFBRBCFfRSFMFHRHbCHMbbCBRHbBbFFSSRBSBBbSH#
#FFRRBFSSFRFHMbMMRbCMMBMCBfBCHSSFCMbbfCCHHbFFBMFCMSRCRFBbBfFRHFCFBBfbHFBfRBHHCHfFMHMbBRRCHfHMRFCBBS#
#fFBBfCSFMMSFHCbCCCMCRSMbMFBbBfbBBSSMMMHHCFSSFBCbMHHBRfRCMBCFRRSMBBbRBMSCMCSHfRfHCCBFRRSMMMMRSHMSCH#
####################################################################################################
