####################################################################################################
#FMCMBfbfMSSCbCBVRVbVSHbMfBVFCCBHfMfRRMMCBHbRfBVHBRffbVFfbRMVfCFBRMFVMHbMfBRSRCVMFVfMRRBVBMCCbVFHHM#
#BVMHbbFRbVFMFFSSMCHMCfVHBBCCMBHCVHBBSHCBRVBbVSbVfCVffBRVfHffBFHbHbffFHfFfFCfVfVSBVfHCHRRHbMHCCMSHH#
#RSRRHFBFbBffCRMFFSHbSSRHfMMCFRSMHfBFCCfbMSHFHBFRMCHFCMbMFfMMCBRVHFbHbCbMVHFFffFfFVVVCfRFHBfMfVMRBC#
#CBVbFbRHSMSbFRSFMbSCSHHFfFCfFBSCSMHbVHRMVRHVMSCBVSRCRHMBCbFFHVMMSHbSfBRfVCCVbHBBHVMHHRRFRHHMSHSbBf#
#fBVSSSMSHCVfSfHVBMSMffHMBBMSSHHbHFBHbFFbVfVCMbVFMSHHfSCbHfFCHfCBSCFMCFVBCSVfMfVFfMBfBBbCHHSfSFSRBf#
#RVBCCSBMBCFRCRRSbSRbVVSRMVRfVVFVHRBSFfBfbRfFbMHSbHbVfBRRffBfRMbFRRRbbbbMCRHfHfCVVHRFFfMRVfSHFfRVRM#
#RBFRRHHbCRBFSVfVBHFHVCMFCFffCCbRSBFSRfFSSFfMVbHbBfMMbRfRHBRBfSBBSFbfHMRBSbRVBSVHbMRSHVSMbRRVHRVFfM#
#MBRBCSSSHVSFMCSMSfSBCBRbffVCRHRSFBVbCCfVBSCVBRMFSfFBHRSCHFSCSCMbVBBBfHHBHMbfMHfbFHFVRHBbCFfSFMVbSB#
#MVCVHCfVCFVSCFRfRMHSVHBHfRBHfHSHRHMbfBCVfRffVHSHRVVRHCSRfFBCVFHfMRMbfCSbHRCRMCfMSRbSbSRbfffSMCRCVS#
#CbCfMVMRCSMMVfMHfFfRBfMCVFHCffBMVVHSCSBVBFHSbbfRCFbRHSFbRBMMCCHRRbFSfBMBCfHCbFFBSRSbHbRCHCCVfbBMHC#
#CBbbCCMFCCCMMBVBBbFMbHFbbfbVHfCBfHHRbFFSbSbSCBMbMMCMRbbCFbBHBbHMbCfSVfVRfRFHVHHCSCRSSFFFSMSffRSRCC#
#RFbCMfSSRMCRfRbBMBCSfbVVVfBbCRMbBBbMBCVfSfMfVCbMRSRFfSfCCbBFVRHVMRfBHSRbbbMCVSHSbHCHMVCBSbfSSSbHSC#
#bVBCFfMFSMBMfMFFBCVfVRHVSMFbBBBSbbbVBVbBfFRMRHVfMCCSCVfSRCbbSHBRRMfRHSSMbbHMFSHfMMFRCfbfHRbbfSbfFb#
#RffbCBfBFbVMRVHRBFBbVMFFfVFbMVSCMBfRRfBfBRHCfFFbVFFSMSVRbRFVbHBCFRMBRSVFVFHFHbRBHBRMbfMbbBSMFHfBSF#
#SCHRfbMVVRFHFRRMRSMFFbVfVBBFfMCHHfMbRbfVbbVBHMVbSfMVHFBbBHFCbVFbbRVRSVBVRMMRHCVfHCCFFFVfVRbfHRCfff#
#bHFVVRRVVSHbVFHCSVRVFHCRFfbVSSHSRCRBFHHCVMBVMCHSVfBMbCHVMBbRfVfMBFBSCCFRCSSRHBSFVBSbfBFRMSHFHCfMBH#
#FBFbFSbVSFHbMCfFHBMRfHHFVRFRCSSBfHbCVbHbSFfCVFFBFbCVFfbRBbHMCFMBbRMFbRFFMFVHCRSVfSCbbCbCRfVRRVBHSS#
#HCRVVfFSMFfFVSBHbVBBCFCfbfHHSBVRfBBVRHVVRVBBRHfVHFBMFRbHFbHCCbSVbSHBCMHbSVbRHSBRSHHFFbHCVFfHSFRCbB#
#HBHHRbBRRRBBSCRRVBFVFBHHMVSfMBMVCbHBVBRSFVSbRbVVBbCBfFVSMRBVCVCRFMSRHfHbfMbHVCbSSffCFbFHFMVHMRFBRR#
#VCHSMBSCSRfMCSVSVFFFbVbBVfbBFBCRFRRCVMSBMHFbBMCCMHBBVRVHfFSCCbFHFMFbHSVHBVfbVfHVRCbFSSfCfBVMHCRfBb#
#bVffbBVCVRFfRRVMCHHHVSbFfHSbSFBFSbSVfHSBRRBHRFHfbSRRVbFCfRBBbRHfHRRHMbVCFFfFSBBRfCVCCHCbbMFbRCCRHB#
#BMMBFHFRBCVRVCHVSVRVMRVSHRVBBVMBVVbFSVRbHFMRFSRHVMSRFVSVHSCRVVSBMBSMbBVVbVVMFffHRFbBVVSVfBBCSBMBHS#
#BfBMbbfBbFVVfFffbRMbCBMFbRHRfBbFbHHSbRfRfSHMSVBVVSRFFHSVHMFVbbHCMSbFbbbbbbHCHMVCVSCCHMSSfVCMFfMfbV#
#CSMBVHRBBCVBHHBHfMfSbMFMVVBVbbHHVRSfbRSRFSRMSCCHFHFVFFBSMHVCCFfMBbHBfVbVCCHVbBCbSHHRMMfBFCCVRMBbFb#
#BMCHFSfFfCCSBSMfSBfHCbBMfBCRRBMCbCFSbRbbCfVfFfHbfHbFVHFfCHBfRVCMbMCbfbSRSRSfMSMCHRCSSBSMHMBVffVCBS#
#bbSFfRRFSVRVCSRMCFHHSbHRMSBbRSVBSHVRFfHCVSCBFRBBRMHBCVHHCVRBSMBfMbBMSBRRFRfCCBCSbfMVHHfHfCSfRfRbMV#
#SRCHVRMbFbVCRHVSMbMSVVHMMCBMfSbfRbHbRFSFBRMHfVSFMBHMHVBMHfHFVSCFSSVMHRbFRfRBVMfSSRBbRBCFpCHBSBMRSC#
#HSffCVbMCCHFHVVfMSVHRHbCRSVbVRHHVRSfVCMVCBRbMBfbfHCbVBBBCHMbSBSSSCSRRSVFMbMbMbMHbBFfMCFRfbRSbMMVHR#
#VRBFfCBCBHFMFRHCVbFBRRfMRbFMHVRCBBHbbRCbfbCHbVRHSfCMRMCBMBBSfVbMbRSbVbSFHMfSMHbVVCHMbRHSHRSVFSMfbH#
#ffRFRBCMSRHHHVHVBVbVHSbRCVBFfRMFSRFFbFFVSMfMCBCCBMMBfHCBFFSBCBVFRVCCfRBSMFHbbfCFCSSSSFfRbHCVMSbbFS#
#BfBCHMSVFSCHbRMFRVFMCRMRbVBSSBBbHFMbMCBSMRCCBMHCbSFMBBCCRCbbRBRBfCbfFVfCVbRCRHfBFSRMVbVBffHfMSRVbF#
#VCFBCbfMSCRfVMSbCFfHVMCbCMBVRfCFCCCBMSbMRRfMVfCRMFRMfVHFbCbHbBMHfCMMMCCRbSVfFCCVRfFMbSfVSVfRFBbFSV#
#HbVSbBVBMFfMVHCFSHfHbHMHfRbfFRBfRCHRHBbMFSbFVFfBFHBCfVCHbRFCSbMVFbHBVSRVMBCfMHbSRBRFfSMFRbVRCBSRVB#
#HBffCbfSBHFFSCRHbBbbMCMCSMSMBFBCBMSFHbfHVbfbfCSHMBCSVFCSRBHHSFbCRCBRfHRSCBRCMfMbCCHfVCRVFRRfMMFFFF#
#FBCMHVVbbMVbSfBfFfMFHCfFBMSCCbBRFbMSBHBRRMfVbCRSCBFHCHfHbHFVRBHRVMbSfMBfMBbVBBSVMMCbRMBVVSCHCBVBSb#
#fRSHHVBVSRBSHFHVfCSRbbfFMFSSHCCMFBfFfHRBVbbfHHSVRRfbbSSRCBFfMFbVFfVRSCMMHRBbMFSFbbFRfbCSFVRHHHCCVV#
#FVHBbfCfVCCMMBBSFBRfHCFBVfbFBbbFRFHSCfBHbMBMSbfbFfFfBBHCHfBVCBMCFRBVRbFCbVBMFCMFRBVbCRFHbRBRCCCHRB#
#SFVCSCSBVSCFVbCbHbbSMVHVRVHFHVRfHVSbHFFVBMBVVMHVFHBfVVCSRSVHVMBCVfCCBSMVVCffSVRbFHBFRSbfVHSFFCFHHH#
#BHVSRHSCFfVFFMVMCHRMVSHRCHBfSBHCBMBBHfFbfFMBRfRCSFSSBSFbSVHCRRSfbfSbSRMffBFBVBVVSFSbRMMBCVBSbFMFSf#
#SBCBMMHbbVbBMBVfFSSCMFSfMVHRRSVffHVCSRVMSRFRSCCCRHCFFCRRbBVSCFHFFSFFSVffMFfRfHFFBVHBMMCSRFHFSMbSFC#
#fbFSbBRfbSbffBFMFSHMMRSSHCCFRBHFRCFRVSbSfSCVHBFfFffBBRBMRMSbVRfHSBFCfVSHMHbSVCMSMbfHMHFfMBfHRBVBFV#
#VBRSbBHHHBHRVSVSHBfFCFHVbBVfRBRFbRFBRVSbMSMFfSRbFbBBCHSBHHHRfSMMbSSMBRfFBMVCMFRSRBMMVCMSRRbBfMFFSV#
#SCRfCSHfFSfHHMHBSSSBVCffFHCffMCfMHfCfFFFVFfRVbBFBBbFBHCHMbMCBHSMHBMHVBfBHCSfBHSCfSVHBMbVVFbVCbFBFF#
#fSCRHMSFVVfbMVRVMbRVfMVHVRHRbHBCVHBbSVVVbRCBVVFCfMMbHBFbHbbRVbCBSSSSbBMHMVBHfbFFSbBHHbVHBRMFVSRCBV#
#SHHbMMbbHRHRfRCCbSFHRfVRffSRbbBRVMMSFRbSfVSSCfHRFCBFFBHfVRfVFFbFSFCfFRSFfCBCBSCRbRRVFFFHFFCHBCSHRV#
#HCSSVVBCCFHMHMSBfbVBVSHMRbSBCFBfRHBHMCRVRMVCCRVVMVBHFHVfffBSSMVVFFfVfVfBMMMMBffCSCbbRRMRCSCBFBCbRM#
#CMbVRFFFRSCbBfFSfVfFCSRCfMVMBSBFbFfCCSMCBCHfVRfFbMfSFfVbHfMbCHSBCRbCRFFCCBfMVHMbHbMFfbMBVfSHRFVffR#
#fVbFFVHRFFfRMfFRRSHMbCRVVCSBVBRRMFVSMSffHHFbCFffFbfSSMFVRfbRbBffbSRCMfSFHRBVfHSRFRbCCSCHMfbBSfRCVF#
#BFbMMMCHbRMHHFCRSVBBMSMRRRVSFMfFHBHRfMfMVFRVRfRHBMRSFCVHBBFSHSHSVRBRfHFbRffSBCCfVFfFVVbbMFFRfMFSbF#
#FCHSBbHbSfBBBCMSVMVRVRHFRfHCVSBSbfRCfbfFBBRfMHVbSMbBRBCMbbRRCfVBCRFbCbMVfSMHVRCVBFVSMCCMSbRbSRHVFF#
#MBSMHBfSfFMVCBbHSMMVBMfSfSHSFCBfVHCRFfBSRCVCBRCMMBMMVHbMbBBCfFSVCRRRVbMMBfBFCfVBCfbfSHRBMVVFRFCfBf#
#MCBHffbSVbFSMFbRCBFBRHFVHSBFMbFVfSRCBFCCCHRRVCfHFVSMVfMRfRSfMRSRFffbMBFbBfFfHVRRCFHfHRfbRfRHCRCbFb#
#SRbVRSFBVMFHHbSMFfHCFBFSSRFbHFCCFSRRRBSMCMfbfCfFffCMBHbRMHCffbVVMfFbbbbbMRSCFMBbFRMSfSSSCbfHHFVfSV#
#FHfMfFRCRVfbVVBVRfCSBRCFbSFSffHCVfMCFBbCCVbCRCBCbHHRRHMfMVMfCMVfFSFBBFRCffFCRVRMbHfbSBHSCRCSSfRbBM#
#RfSMRFSCSSMbVbRBSfHCSMHfCHBRBBHCFfVSVCBMCbVFffRVfMbVFHHfMbVFBfRHMbCCHMHCBCSCFVHfbHRbSRHfRfRBCfMRCF#
#bFCfVHBbSMFFFFbbfBBHRfHRHMbMVRFMFRbVffMVRBHFVMRSCCHHRMSHVCMBVCHCRMMBRRbFMHRHSSVBSCBRfRHbbRMBbFBHHb#
#BCfVHCVfbFMHBMBfRBVSbRFMBSVSFHBSSMCRBSMfRBbMVfMBMBfSSbbbCbRbHMSBfbVVVRHfMSbVSVFFVFMMRfCMSHSVBCRbCf#
#RBBVVRfRSCSRVMSSFVMVCfRHbCCBMHMMFfRbHbCMSbSbFCSbVSFHfCHSMVBSRfBVHCCRRfCFHbbbHBMVBCSSCFBCbCRFHBFSMH#
#CCbCVHSfMRMMHBRSfbfBVSFSFffFBVbCCbBMfMFBbBfCFCbRRRHVHRbfVBSHMSFMbRVHSFMBRSSRVSCBFSVBBfBHbSVMFHRFbR#
#HBCRRSfSbMfbCBCSVfHHbMMFbbHbHHfMSbRMffVCbBCHfBVbMFSSRFHCFMbRBBfMfBSVbFRBSBRFHMMCSHHBSMRbFMVRBVfVMS#
#bbFRRBfVbMFSSVVffMSVRFHMBFMBVSVHbHVHCbfSCMRCfVHbfbMCBMRbBfCVfbFBRMSMVHBBFCfbMSRMBbRbSfRBCHfBMVfCCS#
#HRHFRBMSMCfSSFMMRRHVRbCRbHffBbSHCVHSFbVbSVVVbFbBBbFbbHbbBVCRVBbVfbRVBRMMVBCRSRCBHMBMbVVBbMRBBSSMCH#
#SfMMSbFbFVfRfRRbSFVHMCRBFfVMHVMSMfMbHSHbCSfBFCCRRVSBRBfbCFfbFfFSVRHMSMbfMMHBMBbffBSSCbMbRCBFFCMRMC#
#bMVfCFHBRMMMBFFfVSVFbCSBSHbHBVHHbVBBfRMbBFBMHFCFRSbRbBBCRBBHSBRFMfHCMBVBRbFCSRMSVfHHCCFHBfRRfFbFVf#
#HfCSVFfHHMCRfHCRVMVHCSbVHMSCHFVSBHMfVFfVCVbfSRSMRCHCbVBBMSffbRVRRFVbFbSbFfVbMFFfCMFRMSBHMffVFBMVfB#
#SSSMFVVRVSbCfbfFCfFfVRVMFSHVfVMCHVSbMCHMCMMHffVbSHRHFbSRfBfMFHfRFbFVSbbFCCfCCFCSCBFRHHFfBfSBfSSSCf#
#fBSSVRVbSCVSSHbMVSFSBfCbSVFVSRFHFVHfbSVVBSMSSfVbHCSFfMSCCMfRMMBbRbBSCMbHFBVCBbbSSCBSCVRHHRSbFCBfMS#
#SSVBHBFSfMRFFMffMBRSfHSCSVBfbCFBSMfRSVRCHMBbRFSbRVCHVRFVSbSBMBHMRbMbHfHHRMMffVSSfbffVSHSbRbMHHMBSS#
#MHRHCRBSMHHSMFBCHMMSCRMBBSMBHHSbHFMHRbVCfHCSSHCFSVfCMfCfbRSSBffHHMBCCfFBRFBRfVFRbBMCfMCMCHSCbfSBfV#
#BHRCHSbMMfFfMVVVCHCfBSRHHVFRbRVSMMbRfMfFBMMBMbBCRHMBfFSfMMCHffRHMMRRbfVbMVBVHfbVFMFRfHVHVFHMRMFSCM#
#RCMRCRMbfbSHFMVVFfFSVbRfbMFbFBRCbFHffSbBVSBHbSVMHMSFfFbSMCMFHHCbbBMSMMSCBHfFVRHSHBbMCHbHMFSfVHVRMf#
#bMSVBVHbfRVMVMSCMbSHRRCFfMFMMFFfRBVRMbVSMffbfCbMMHBCHMMRCRCMFHVSSCVVMRMSRfVCRMHFBVFfBbMMFfMfFCfBCV#
#BBfVSFVRHVBRVRbFRSVffSRBRHbBbRFCHbVFCVMMbSBbbMFSRVRCBRBSFfbbFfHbVMBHHbHSVHCSbCfRCSRfHbBRRfSHFfMVfC#
#VMHSMMSbHRRCBRBfbSBCHBbCbVFRBSSHbMFRRCHCRRfCCfMHFMSCHVBbSSVSHVMSHMffRRMSRHMVMBRMCCVBbFCVHVMHBSSfbH#
#fCbfSSfSCffBBRMfVMSfFHbfbHCbCFVRVBVVSbFbFVHBFVHFMVFfbbVFRCVFVRRHVVVCMMMRHfRFSBFHHfRbHHSBHRFBffRfFH#
#RVCSRfbCFCMBfMSfSRMVMRHFBfMCSHSSFBHbHSBFCbMbMMbFCSVBCFVBVSffRHBbHRBSRbfSVFHBSSbHSFBCCSfSbVCFVSSCFM#
#SBbBVRFfHCFVFfSbFFCfFBMbfVRCfCbSbbRMCVSCFSRfbfSSBBMFSfbSFHRMVCHVSBFBbMRCFVBFfRCfSSbVBMHHBRBMfCbSfV#
#MbbVMBSbFBCfMBFMSFSfVHMfFHRffVbHfSMMMVMVRbFSHBFFFSCMfBVBfCfffFRRBbBMCMBbfVCFfbVCfVHMbRFCFMFSFfFCSC#
#fVMBHbBBfVfCVMBfFfSFSVFbHMHVHMHCFFRSBCBRVfFBHRFMCHfBfFRVFRfRMbSRRRSBRMFBVVfVBCfCHFFCSfbFSFMHBHVRVF#
#CRbSffHfMBRbSBSBfCRVFBMSCFffRFFMCRfFfMVCMRbRfVCfVBVbMfbffRHMCSHbFCCbFbSbfbfFHFRVVCMSSMMFCHRHBMHVHS#
#HBFSfRCVRHRMbFMBHVHMbRbMfMbVCVVfRRMbBHHSBBMFRfCFbSCHFVFFRMHBfBCSFCRBVBVHRFRFRFMRCMSFSCRBHFFHVSfFVS#
#bHBHVRHFMbbHbHCfFbfFCMFCFHHRFSbVFMMHbHVbRCbfCFCfMbFbHRFRVRMRRCFCCHbCFMffCCHRHbSVSMRSSMVRSSMVbCMRHC#
#fRHHSFFMfFHRMFfVbVVHMbHVHFVVSHCSVRSCRMHHBSRfCBRMVSFVfHCSSMVMMHRVSbBfVbBFMHCRbFMFBbHFSCVfbFSBHfVRSC#
#bHbBHSBFRFFVSHSbSfBHCBVCRVbCfHSMCRVRHbHHHRbfRMHMRHRBFVBCFRSbSbBVFVfMFVSMMBVHBCbRSCbHbSBCbbSHFVCSRf#
#HMbRfRSbRfSFbbfVbHSSHMVHHHFMBVBBRCCSSBVfCSHRFRbHCRFFMCCBHbFRbRHFVfHHRHHVbfCCSbBfMFbSfbMFfBHVRHRVCB#
#VHfbBHFSVfSbbfVMVVFfBFMRSMCFbBbMFRHRCBSbHHSBCFHVMVbMfffSHHbbMSFVCfMbfCbRVVMbfVHVVbRVSSRBbFHCRfSbMH#
#fCRCVbFBBCfCFHMBfSRFMCMCVSCVSRBHVFHfSfVRBBRSRMFMRSMRMFMRfBSBRVFBCFCFbCFSHRMbRVRRVFHVCFBBCSbFCfSHMR#
#SBRHBFSBfbHFFHbCHFfFVCSfBHMMbFCRRfRVbCHfBfbfMFfMHRVFBVfMfMSSfFRMfBMCbSMVRVSMCBCSSVfBfCCVFBBSRbRVBR#
#VCRfSCMVMRRVfBVbBRCMbCRRRHRFHCCBVFRSCfbMRSHFfBSFCFRHVVRCSSFBMbbSHVBFSHSRBVFbRFfMMfHMCHfFFHbRfBHFFH#
#RfSMHVFMMFVRfRfBHfMCCbFRSRBfCbVFHSHVRCBCVRHRHVFFRSbRCSMSMVCMFVCfSbbfVVSbbFVMbFMVBHMVMfBMFfVRbVSbMV#
#bFRMbCMRSbVRHFFHfSBFHCMVHHbMMCCFFbMMRfMMRBBbRbVCfCbFCRFSbVHbCBfSMSSVbVHBMVVVbVBMHCCSfSVbbfRfHCbCfC#
#SbSHRRFbbfbFBMHHCbCVVVMRBfMHMbbBHCVbSHHVRBRfMSFffCVMFRFMbBRfSbBHMHFRFVHMfRRRRFCCBBMfFbFBMHCCBCfbbS#
#BbSffbSFRRFFRFSSCRMSHbVVVSFbBBFMBSCHFSRHHMMFRBRVFVMVVMHCRCSffBVFbSVMfHVCCRSRCRbCVHRHfFHCfCRVCSRSHf#
#CRRfMbVbfFFHRCVbSSBFBFHVMbFHfVMCFMfMHSRHbSbSFBSHHfFbCVCfCCfFSRbSBHCSRBBFHCbMHBfMFVFbVFHMBMVbCFHMMS#
#MBVRRMVMFVBMFMbHMMFfMRfBBbFCRfSRBFVHMbSHHFFbRVbMRBCCMRbbRHfHBVCSRfRBbSfVVMSfBfVSVHMbFVHfVCMBVBfBCM#
#bCfHVCfSHCVRSFRRSHRFbRfCSHFfRCFFFVVMCfFSMVFFMfbSBMBSfMMCMCCSCbMHRVRMRSRfMCSHfFbSMbfbBbbfMBbMbSfHbV#
#MHHVMBMSFBFCVMVRfRSCbbHFMRfMBRSBRSVbBHCSfCHRVMFbfMBFfHBbfBfFHHFbfFFfMbFMCVbfRRSBVbMHBVbSBVMSRSMVMC#
#VHfbRVRfCHbHfCfCFVFBFHfMRbVffRRFfHSCHRFCHVfMSBBbbVHHCCRSFMFSVbVSVMCBfBFRBFBbSCHCCRMBMSBVBFRbBVBHCR#
####################################################################################################
