####################################################################################################
#FMHBfffBBCFRbMBBFbHbRHMfFRSRBBHCfFFHSHfBbBCSRCFBHHCRCRbBBCHSSFHCCMBSFCFCBHCHbSMHFHFRFRSMSHBSBRRHSB#
#bCRFCFBbFRffbSCRHCCfMCbFHCbHbFfMfRFHSMFfMCHSRbBSCHRffSCCSHMHbHCfSCfCCRRBHBBSSCCHRSRCHRfMBfRCBSRRFH#
#MbbRCbfRRSMSMMMBMBHBHMMbHHCbFbbHSMHbRCRbRbSbRCBSMfBMRSCHMRFRSHbbfRCFbCHbRbRSSFSbbBbbSBCRFbBHSBCRMH#
#BBCbCFCBRFfbCfFRSSffffFBCfSSRRfSbMCRFHFSbbfRCFCffCFFSFBBRBBFHfMMBbFfbSCMFMRffCBfbSfSfMBBfBMSfFMFRS#
#bRCCMbCFHSSBRBHCCbbFfSBRHMfFRCRbfRBBCFCRCHbHbRHHHbHFRCBFMfMfMRFfMHfSMbHbRHFCFSCBFffRbbCRBbHFfRBRMb#
#FHRfRBfCSHBbRBFFHRfHCBHCBfMSSBCFMCSFSMfFCfSCbBSfBfBfCHFSffffFRBBBHSMHfFBfbHfHMBHFFHMCRfRRfBMMFRfHM#
#HMBCCbMRSbRFbCCbbFFSfFSFbRCMbCSMfbBFfHSHCFBHHHFMRbMBMMBbCFHbRCRRMfSffbHCBBRCMRFSRRHSHSHfHMMMRBMbFH#
#MSSCfSHbRCbHRFMSfCRfRCHHbBbFbSSBSCBFBBRbCMfbFSFMHFRCRbCBCSbRCCSMMFCMFRMCfRBbBSFCSSMSHCCMBSSSHFFHCH#
#RfSRBRbHfCFSSBRFSFCHfBSfbMRMMbFbMCHRRSSfMbRbSBRSSRRBBHHCRfbHFHHRfSBCCHSbFfMbBRSHFRbfbSbMCSCBHMfMff#
#CHHHRfBFMCCBRFRfbffMMbRbSffFHFCHBfFbbfMHffRFfbMfMbMCfbFMMCbbHFfBbMHHBfBMfRbMBHSfRRMRBBFBFfHHFBBbSH#
#MSHbFHBHfCFRCMHHFMCRCRMMMSFRSFCCCFHMRBMHMRSSbHHRFRfCRFCSbfHBBfCSSfBBRCSBfRfFbRCMMCHSbCBRBBFMfFfHCC#
#MSBHbMRMHbBMBCCfffCHFBfbBSfFRfbMFHfSbCCRbSSRMbHbSBMFBMSfSSMfFMbRSCMHFCMbMHFbRHbBRCRBFfbbbfSSFRHBSS#
#MfFfRBSFRbbCRfCFRCbbRHHHCBFMfSBbbBMCSSCCMFCMfRBSCFbBSBbSSbBSFbFfRHBbSSHSBfCSCfCBbRCRFSSCfHfCFHBBfR#
#HRCHMHCBRRBFSRfBHCFFRHBFfRCBRBRCHfBRSFHSMMSMbSSRMFFHMRHbRfffSbRfCCRFFBCBBMbCMMbMfFbSSfbHSfBffFBSbB#
#SbbfRMFSBFFMFMHFRHMHRFfSRSHBfMCHHMRFFRFMCCbBMFHSCfFMffFRSHCHFSffBFbMMfFfMSRSMbbMbRSSMMBCSCHCMSRHBB#
#CbbFBSBMfMSfMSHMbfMfMBSBFbHRRBMRRFbCbbCMCHfbBCFSMRfRFSbFHfBCCMHCbMfHRSSHMMCMMMCBBFSMBSHFBMHbSMBfHS#
#MRMfBHMMSHFRCCbSBFSbSRBBfbfSBBHfMbMHRRFFMCHfCFbbHbMfFHFFSbbSMRfSHFfSfbHHCSMfbHMSBBbbSBfRHffRMCBRbM#
#bHRSBBMHbSCCfbHHRCHbHbMFHBFRBHHFFBfCFMSbMffFHffffSbFSSbRCSfCRbSBbfHCSfFfSCCHRSMBFBCBSRHMSfSBMBMCFH#
#MBSHBfMRMBRbMSCMHMbfCfHFBBCBFSFMHRCRMRMSMSMHBfRHCFHCfBHMbRSHfSRfBBHCMSFMCHBCRbMCBbHFHHBbFCSFBBMCBS#
#MSBCCSFBbbBbHSSbSbFHRRBFHHBFMMbCBfBbCFSfFHRHFHFBbffRFbCRBHBbFCCRHHSSHRHFMfBbBfSFBBHMHMMCBCCBRFfCMb#
#fHFRRCSSFfRSMRbHRCFCHHRCSHMCBfBHSRRHBSbBMRSSHSSHbFBRBMFfSMfHSFHBSMRCFfSCMCMFbfMSMSBRfMMffbBbCCBCMf#
#SBCSSMRbMbfCHSSFSfMSCCfbbBfMRbMFRFfSfHMSCSHbbCRbCRMCbbfSFFCBbCbCFMFCbbHHMCSbFfFfBBfCfSFMCRbMRRffSR#
#BfRMFFBRCSHfFCMfSHFHCSRbMBBBbBBHBHMFfCffMRHRBBFMBffRbRRRffCHbBBRFFRCCCRCBMfRCbRRRHffMRFbffRSbSBFSM#
#CCCFBMFffBBHFRbSCHbfFfMfMHfFRSfbRbFSHFbCHfbbBCbbfHFfMSRMFbMfbSSRMRfHMCSSRRfBfSRfSMfFBbCBMMbbBbSSSM#
#fMSHFMfRBHHfSMbHCCCCBSMFffRCFHSHSbSBRFMffBCRCfRMRbRRBSbHBHSHfCSHSCbHHbCbMSCbRBCHMbFRHBBFBSFSFBBbFC#
#RMHMBHFBHFRfRffFfHFfCBbfffMCBFMbSFBHfCHHMfFHMFFBHRSHfHffFCBSBHCRRMFBHFBSFCFfbSfSBfMMCffFCHfCRRSFCB#
#MHBfFRbSCBHFbHSFSMfbHHBHCHbBSSMbFFbBSbCCCCCFMHFCbfBbBfHHbRMMMbMRHRFSHFBbbCMFRfMBfBSCSSMfCbHBHRMBCF#
#HHFHSHRRbMFfSFFCRSHRCRSSbFMBFSBRRbSMRCfMbHFfCBffbCHSCFSHHFMHbBHbbSRFbCfCSRbCHCMMFBRbbHfFHffbRbBbRH#
#CSRCHBSCBbHBFSSFSMFBBbbHBbMfBMFbMfHRBBSSFfBHbCbRRMRbCCCBfHMCSBffMFCRFMCFMRCSfCfBHFfCSCHSSFBBfHFRFR#
#bSRSFCFMCSMRMFbFSbFHFHRbbSHFMSHSHSHBMBbHBfCMbfFbHMMSMFbFFCBCCMFMSfHCFRBCSHBSMSFSMMSbbRCSRfCHMRHbfF#
#HbHBMSMBHCbbFRMRbFSMSSbHSCSBBBCMfHSHHFMSbCFfbRBRMBHMSBCHMBfbCbFRBbbMRMfHSbFFCbSbBRCFRMSSRfHBBfCBbf#
#fBHCCHFCHMMFSMBRRbHfBRSffCfSMCSSMCCSHMRFSbCHHbSfBFHBCbCbRbCMMfHFFRffSBRbfRfbCbSFMSfRbRMHbRCbbMHRHC#
#CBRbMSCbbBHRBbRRfbbHMMfFFCMfHMBCbBHRFbRHffCfFffSHSHHMMRBffCBSFfHSHSSMfRBRCSRSSHSHffbBHBHSSMHFFCfbf#
#BCfHMBbCbHSBCFbRBFCRSfbBbRHMbCSBHFMFfHCRBFMfCfBSfbRCBSfHMRMbHfSMHbMHCFBHMSSBHbfRBMSHfSfCFbbHBMHHbf#
#BCBfMHfRHBMSHHMRbMRBRBRBbFbHBMbBSfbRHCHSfFRCMRBRMBCRSSbbBHSRHSfRfRHBCbRMSCHBHSCSBCRSRCRFSMSbfMbSHH#
#FFBfMSSHSRFHFCHCSRRBSbHMbMHMHSbCHbBCHCMFMbSFRbBHSCBBfbSSCBBfRbCbfRBCSbBSFCRSHBFFFbbfRFFSBHSRbCbHbC#
#FRbBBFMFfBCMSRfbfBbFHRBbfMBFSFSbMbBfCbbFMfRHSRBFfRRBHBMbBbCBHRMRSHHfbBBbfRRCbRSHfMMfCFCbFHCfffRBCF#
#FHbfSbFBCBbBCRfCbHfBbFFfbBRBFRbBHFfHCSBFCfMMbSMfFSfSMHMbBCHSfCHMfFBfBSHBHFCMMCRCfBMCMbSMRFFFCFCCCb#
#BBHbbFbMMSCBbfCFRSHRMRMBFFMfMbfBbSFfMFCbHHSSCSHCFBHbbSbRFSfCFFBSCHMCfSCHHHSfffSFbFbMCBSSMSfMBCHBMf#
#fRBBMFSFBBbBBbbCBFFSCMRCfRCfBSSSSbSFMHCFRSMbfSMSFFbHBBRBfCHSFRfFfHbRMfMFFRfFHbHfFFMBCSfCCRHFRFMMFb#
#MFHBCSbSFRHCBRRSMCSCbfRHfHFMRMfRBCSCFBFMRRRBbBCBMfSHSFRCFCCFFbCMfCBSBfHSCbFfMSRCSSCSbffCCRRFBfMFfH#
#SHCBMCbRBMFHMSbMSBBCBMBCFHSCfSHBFBfMRFMFMHbHHMBfBbbBffFSSRBBHMfBbHBMBMMSbSfCCMBHBFBfRSFHSHFfCbBFfb#
#HHCSCfBMfMSbRfCRfbMFHBMFCHfRMSfMSCHMRHSBSFbSMRMRbSSRbSfRCBRHfMBSCCSRRFBbMMBBSFSbHHCFSCSRMRBSMbCSMB#
#SSfbCBFSMSbFFRCMMMSHHHbBMbbFbBSRbFSffFRHCfFbBbRHCBRBRCFbBCSBBbSBFRMMSRFFRHbRHbCBRHMMbHRMfHBCCHbHBb#
#fBRRfHBSSBbFSMbfRHfHMbHHHFSffHFRSBHHbSCfSfMRRHbRCCCfFSMFfbSSfMbFCRRbBBHbFfFHBCbMHHBFCfbCBCHCbRMffR#
#bRFMHbbCRMBBFMMMbMHHRHMRBbSHBfBRRSFMMBCCRCSCHbfMCRfMHfbbbbffBSFBRBfSFBHbbSfMMMbHMBMRHSSSRFFHHbBHHM#
#SHbffRFbbMMfBFSFMbBfSFHSCMFBMbHBBSRFFMBbRHSbMfffCbFffSSFHFBBSSBCMMMHCMbMRfHfMFCBbMMFBfCFbRbRBfHHbf#
#CSSFfHSbbfHMCFMSfFBSRRfRMMBHRfHRbHFMHbBMfHSFSBHRMFBFBbbMbbMbfRMCfbBfbMFfBFMSCMBfBCBHHMHbfSBSMHFMSF#
#HfBfRCHffMMbHBMfSfbSbHRRbbMRCMBCbFffSCBffFSfSSCbCMRfHRfbHHBfBbRCfMHMMSHFBFCHbSfBfFfRSRFMRFCFCCbCSM#
#BFbSRBCSMMMFSBCCHRBfbfMRMHHBfBbCBFfBMHFRBHMHFCCfMRCSFbRHbfMSRFBHMbBHBRRbSfFSFFBMSCHFHbSCfbFSSFBMbS#
#FFRMBSCHfHMRFfBHFfRbRSfCCBbfRMRbMCCMfMBFHMRBbRSCfFfBbBMBfbMbMMCFRfFSSSCRRCbMHRCFBfBSCHBSHCCFfbRCbB#
#fCMSHHbBbSMHSSRRffBbHbSRCCMRHffCHFCbFBFBfRbFfMfBffHSHfffRHSFbCRSCfbbFCSMCRRFMSbHMMfFCfCCFfSfMfbCbf#
#FbHCFbRbfHBCRfbHFMbHFBRbCBMfFHbbbCffBSpMRSHRBFHMSSSbfbfCSRBSMMCFBRRCMSMMMMHfCHfFBFRbMFSFCHCFSMCfHM#
#MRCRBRfCSSbCMfSMfSBHfHCCMCSHCMCfHfbSbBFbBHHfRBBfBBBSMCCCBMbFfbFHbFMHMSBCfMMCbbCCCfFMfRMHMFRSCMCbHH#
#bFbbBFMRBRHCHSFBMRfSCFBbSSMbRMRfbbbfSSMHFbMRHbHHMHSSbRBBCbBFFHfbCFCRSHbMfSHSbSBHRBCRRFfFfbBbSSSSHb#
#bHHSMbHSBbCfRRBbRFBbBCRSHFRBMRSBMHCfHBFBfbbHRCMHFHSRBbSbFSFRRCFFHbFCSSRbHfHbSFBRbHHMfHFRCMBMMHMMbB#
#FbFFMfFSSCbFCBCSFSfBfBFHRSCCCFHfMCbRCFMfCFFMFRFBRBRCRBbCffHbfBFCFFBFFBHFRbbRSfSSSSbMHCfRCCbSfBBfSR#
#fCBSRfCMSHFMbFRMbBMMBFMMSRFSCCMHBSMMSfbCBSMCfHBHSMRfMfBBRFCCRRBBBSfRCMMffRFRBHHCbCHCHBRMSMCHfMCfBH#
#SfbSRMSfHHMHBfRCRMBSHHHBCHMBHMSBSHbFSbHCCffRfMBfbfSbbSCfbRSBbMFbBBSHfHFSFBSFCRSCFCHMbSHRFBCSFFBCRf#
#CHRfbCbBMbfBbfFCCfBBBSSfFFbSBbFHBMFFbBSHfCbRbBHRbHbMFMSfbSSbCBFCBSFCBCBBbCCRbBbfHMFRBMSfFbbCHMRHSH#
#BSFCSMSMMSCFCRHfbFMRSHMFCHRMMMfbCSbMFSMbRSfMRFMFRFSRbFbHbRMSMHMCFRFHRCMRRCSSCfRBSRRMHbCMBBfCSbSRMM#
#BRHMbMMfMFbbHBBHCbffCMMCbRBFbSBBSbHCfbfSSMFFfRRfBSRfBfBbHSFHfBbbBMfHRFHCFBFBCRCfBbRSBBHMFRSHFHSBRS#
#MSCCSBBRFFHSHMMRMbBMHHRCfRMHffCCMfHbHCfbfSfbRRRFBCMCCMSHHBCbCBSbFfFBMSFHfHCBbBfMMRRBbFBBRHfCbBFFBR#
#FRRSBFHbSCSSHFCbBHHHSCRFBfBBMMBfHMSbBBCRbMFfBfCHMfBFRMbHfbHfCCfFHBMRBbbFSFCCCMBMbRFHffRbFSffSRRbCH#
#MRBBBCbfbCCbRSFHbSfbffbFCHBFFSBRFMMRCRCbBbCfSFHFRSbSRHBCMHbBRBMfBFMMSHHbHBSBFfFHffMSbbCbHbRBBBbSCR#
#MMFBbCbbMHbfbbSSCCRRSHFHfbMFRCHSHFHFbRCCHFFBfSFHfSbRCFMHFHSCFfbSMbbfMbCCRRFHRfSHfSCMfHSbMCFMSRRBSf#
#fHBbHFRSRRHCSSHSHFMFRfBFFHCfRbHfFRbbMHfCHbHbCHFCCBfRFRBFfMBFRRRHHMBSMbCRCFMFSSHRHCBRRBRMFBRbHMFCCF#
#FCfFfHfCSCHSRRbbbbFBfbRSFbRHCHCbRSFCHfRFSFMfCRfMSBMbbCHSRFMCBSMSBfFFRSFFFSHBRSHSCHfMHRfHMbMFBFHfHC#
#FBSHfFHRMFHBCMRRRSRCBbMfHHSSMFBffHBBMMbRSSFSHRSSfFBMffHHBHBbBfHCCBfFBfCSFRBbffHRMFfHHBHRHFBMbRBHHR#
#bCRSfBMFFSHMHbbbFFRFRCMBFbSFSffSMCbbMMbCMfHFSSfBCRMFHCCHRBMSSFCMSHHCSbHMMfRSBSHFRFRbBMSfbffBCSSMBM#
#SbFMCMfbRHHMFBFFFRfFFHCSbMffRBbSbRMCBMMMRBFbRFSFFHBCbMSMFFHbMCRFHSRRSfCSbBMBRSRCRCSHfMfCCHfBfCfFCM#
#CHCSbfSbfRSBHSRRCbCMbBHRCMMHBfMCbBMBRSRFRMHSSMHRSRMMRHHSCFMMfbBMMSSBSFHSbMRBRMBfFBBHRbFSfCSbBSffCB#
#bCRMfRHSHHMfbFMHRRbMRHCSfCMHSRMbbRRMCRBMBHCbSHbSSbHCMFBHFRHMSSFfCfHSfbFbfFFMBbMBMMMRSSRHfbbMFHfBCC#
#bFCCFBRFSMbCCFSfbFfHSCMMHMHbMbSBbbFCbRSFbbRMfFFfFbMCFHRRBMSBRbCHCBRSMHbMbbBMMBRSFFfHBRMBfHFbHfBSbf#
#RbHBFMbHBbMFMSCSFSbMHHHRHHSBCFCBHfHBfSRHbfRSCHSfHSHHBFRBCCMFHFMSRMRRRSMRMMHfFCRbBBFFHCHSCffbBSBMbf#
#FCSBFfRFMFMHCfbfHfbBHbFffCFbSbRFffMMbSbSFSMBbCfRfRBfMSHbRfBHBMMCCBbMCHSfMRFFbMMSHCCMHCRfHfFMbfBBHM#
#CbFMMCfCMBSMBbfSbBCRbFRMRRBFCfMfBBRRHRSCRFCMRbFFCMHRHBfBMCSRRbRRCMHfSbFCfMRSFMHCBBbMHbRbSMSFRCRHSH#
#fRMHfMFMBfBRFbbMbRCFMMCfCSRRbfSfSMBFCSSRRRSHffRSHBHCMFFSCRbMRBbMRFCbMCBMHRMSRFSSMSMfMSCFHFSFRMSfFM#
#FffHFRfbFbSMbfbBHbHFBRHFCBRfMFMFMBbRCHFSSRMRfBfCRRMRBCFBSbbFHRSCfRFfffBffMfBRCbRBbCFfHMBCRBBMBCHFC#
#CfFMMSbBHbBFMMHSSBMBfCBSMSHbRSSFfBBMRfBRMRFCRfSCBFfbHMFMbRCHSFMbCSbRBfCSHBMMHfCFbCBBbbFfBfMffSBfRB#
#bFBBbfMBSFSCMBCBFMfbRSMBbbffFHCRFSBbFMRFSHbbSCRbfCRHfBSSFMbMMBRHSSbFBbfSCCbMFCFHHSBRSCFHRbfCbbMMMM#
#BMFBfFMfSFMSbFHfbBRRBSBBHCbMSMRFFFRfSfFFfCFbFfRFBMfMCCFRHMRMFCBMFFFHMHBbRfBfCRFbHbbHFBRMRbRRSSCHMB#
#RRFbfRRCSCHBMMFFCffRHRMFCFFSRMMSfCHHSBfHBFbHMfRMSHRBHFMMFfbHFFbFRRMCSBHCRSHCHHFMRFFBCHfBBRHSbCbHRf#
#FbSMSMHSCRHfFFMMBCbFBfSRCFFFfHFBRSSRfCBSfFBBCBHHMBCHSHBMFMHSMHHCCbSRMbHBBHMMRBBbSRHfHCbbbbHCSCCBFR#
#FRMRHffCfHMSCHbSFRCSCCfBRSMHSMHHHFFSbCFfbRFbBMRSHFSbSFCFRRRSRMCCBHRBCSRSfBfSMSbMSHFbbbbHbbFFMCSBFS#
#RBfFMSbMbHBbBHBfSBRRFfSFfFRFFfCfRRFRSHFffMbfHCbBMRfFbfCRMSRHMbCCHHHBbbFHRHHRCbBRCCHBFMbRbFSfRMfMCM#
#HfRSRBMfFHbCFfCbMfHRCfMMSCSCfHHBFRBfCMCRbCBMMBBRMSCfHbbMSbMfFFRBbbfCFBCCRBSHBRBCBHHRMCSbSSCFfCSCRR#
#MCFSSHfbbSSMFSFFRfHCSFSHSbFFfHMffMfSRSCfMHBbfBCfSMSCHbMSBfRSHbFRHMFCRBHBfbSBbMHCbFfMHSSHRHFfCBBCbC#
#CCfCHFFBfSRFCRCHHfffRSCBBbRRSMMSfSFBfCfffFFSBCMMSHBffMRMSCMFSfbCFFBCHMfSBBRHfBfbfCHHHFMSRSRMRFSFCF#
#RBFCSbCfSbMCSRHFMSBBfBBCBbbHMbFFHSMRSFbbSFRRMHFfRfMSHbRbSbFHMfCRFBMSMHbFbCMSbMRfRCSBBRCFHBFHSfFRbR#
#SCfbSHBFRMSbRHFBBbRMSCfFfHRbMBFFSMMSCfffMbFBRBHbFSfRbFFSRMbbffBMCfRRCfHRCbCMbBSFHFCHbCMHSRfbBffFMC#
#fSSCSRHBbFBBCMHHMHHHMMbSfMMCRfCCCBBRMSBFMSMfBRfCbHMSBHRFRbRCMFSHSMSbBbMMBMBRHbfBCHRFbCBCCRRCCHHfbS#
#FfHFbMSHMBbCBfFMCCHBFFfSFbfHfCfHRCHHMRSfBMFSCHFBfMffbRHMBMFFCBBSHRCMfbSCMSbMCCFHRRHCSfffBCRSCBCBCM#
#fRbfHBbFfRSSFBSRRfCCRBCFMRCfCMffBBRCbfBHbbHRHfbFBRSHBHRRfBSFfFbMFfCFSHMbMSCSSHSRMCMBBFfHCfHBRBFBFS#
#HbfSRfBCFMfHRMMMfMHMfRHSMMHSBHHSRMCSSHFSRRBCSbFRCfRCMFfSRMHCFCBCCSFSBBBfFFfFSFffFBbbFHCbbBFSBfHbbf#
#RSSHFBbFHMRfRfSFMHMRbHSSFfbHCBBFHSRCRFFRbFFHBfHCFbBbMfSfBHfSbRMfBHMMFFCCHMCfBHBCSfFRCHbMHfffbSbMbb#
#MMfRSSBSBFHfHBbfFfMRHHMfSFfMRFHFRRMCCCMbFBSBHMbbbbMbbSHRfbFMRfCCFFRfRCHHHFfFbFHbSFFffFMRCFCCFHfHHF#
#HSRfFBRbBBHBSCBBMCCfFbFbBBRCCCfMFFFCbBHHFCRRMCFfMRHBSCHbCbBMRBBMCHfffBBFHMbHRBHbFRFCffCBMMFRfFCBCF#
####################################################################################################
