####################
#                  #
#              HpH #
#                  #
#       HH    S    #
#         H    S   #
#H   H             #
# H                #
#     H            #
####################
