####################
#        H         #
#H pH        H  H  #
#    H        H   H#
# H  H          H  #
#      H     H     #
#                  #
#      H           #
#          S       #
####################
