####################
# H H       S      #
#S         H       #
#      H H       H #
#                  #
#        S         #
#    H             #
#    H     p     H #
#         S        #
####################
