####################
#   H              #
#        H  H      #
#  H         H     #
#      p           #
#H   S  S    H     #
#    H    H   S    #
#      H  HHH H    #
#            HH   H#
####################
