####################
#H    p     H     H#
#          H H     #
# H            H   #
# H             H  #
#  H         S     #
#S                 #
#         H       H#
#    H          H H#
####################
