####################
# H               H#
# HH S        p    #
#                  #
#  H          H    #
#     HH  HS       #
#SH        H       #
#          H       #
#  S              S#
####################
