####################
#        H     S   #
#     H  S SH  H   #
#                  #
#   S  S           #
#   H HH           #
# p       H      H #
#     H            #
#            S   H #
####################
