####################
#   H   H   H    H #
#    H     H     H #
# H    H      H    #
#  H              H#
# H                #
#         H        #
#     p H  H       #
#           HH    H#
####################
