####################
#    H Hp          #
#           HH     #
#   S       S      #
#      H   H   H   #
#S          S HHS  #
#           S      #
#              S   #
#H                 #
####################
