####################
#                H #
#       H          #
#         H        #
#       S          #
#       H          #
#           pH     #
# HH   H  H      S #
#        S         #
####################
