####################
#       H          #
#              H   #
#               HS #
#       H          #
# H      p         #
#                 H#
# H   H     SS     #
#        H         #
####################
