####################
#    H             #
#     S    H     H #
#               H H#
# S            S   #
# H  H H       SH  #
#    H             #
#    H H     H     #
#               p  #
####################
