####################
#  H              H#
#H                 #
#                  #
#  p      H        #
#               H  #
# H              H #
#                 H#
#H                 #
####################
