####################
#      HH      S  H#
#            H     #
#         SH       #
#      H pHS S     #
# H           HH   #
#            H     #
#H H             H #
#              H H #
####################
