####################
#           pSS    #
#   SH             #
#                  #
#  H S    H        #
#   H             H#
#    S             #
#   SH  H  S      H#
#              H   #
####################
