####################
#               S S#
#     HH H    p    #
#     H     SH     #
#                  #
#   H              #
#S            SH   #
#   H       H      #
#       S          #
####################
