####################
#                  #
# S        H      S#
#             H S  #
#   H        S  H  #
#           p H    #
#     H            #
#  H          S    #
#                  #
####################
