####################
#                  #
#       S  HH  SH  #
#   H              #
#H   H   H    H    #
#                  #
#  S               #
#  H        H    H #
#H     H  H       p#
####################
