####################
#      H     H     #
#   H              #
#         H  SH HH #
#            S     #
#      p   H       #
#          H  S    #
#          H      H#
#   H   H         S#
####################
