####################
#    H             #
#H       H         #
#                  #
#       H          #
#            H p   #
#               H  #
#               S H#
#          H       #
####################
