####################
# H      S     H   #
#            H  H  #
#       H      H   #
#      H     H     #
#        H         #
# H           pH   #
# H S   H   H      #
#H            H    #
####################
