####################
#                  #
#      H   p       #
#S  S          H   #
#      H       S   #
#           H   S  #
#      H H H       #
#    H    H        #
#H H  H      S S   #
####################
