####################
#                  #
#   H         H    #
# H HH H HH        #
#     H            #
# S  H   H         #
#   H  S   S S     #
#  p        H    S #
#             H    #
####################
