####################
# H    S    H      #
#        H H       #
#            S     #
#  H             p #
# H  H   S   H     #
#H   H      H    H #
#    H            H#
#   H         HH  H#
####################
