####################
#     H      H     #
# H      H         #
#                  #
#                  #
#      p H     HS  #
#                  #
#         H        #
#        S      H  #
####################
