####################
#              H   #
#      H  H  H S   #
#H    H            #
#        H HH      #
#H       H         #
#  p               #
#   HH  H          #
# H         H      #
####################
