####################
#   H  H          H#
#                  #
#      S        H  #
#     S  H    S    #
#      H  H        #
#S             p   #
#             S   H#
#       S   H      #
####################
