####################
#     p H    H     #
# HH               #
#H    H           S#
#S      H   H H    #
#            H     #
#   H     S      S #
# H                #
#       H          #
####################
